阿	阜 可	阝 可
锕	金 阿	钅 阿
嗄	口 夏
啊	口 阿
哎	口 艾
哀	衣 口	亠 口 衣
唉	口 矣
埃	土 矣
娭	女 矣
挨	手 矣	扌 矣	才 矣
欸	矣 欠
溾	水 鬼	氵 鬼
嗳	口 爱
銰	金 艾	釒 艾
锿	金 哀	钅 哀
噯	口 愛
鎄	金 哀	釒 哀
啀	口 厓
捱	手 厓	扌 厓	才 厓
皑	白 岂
凒	冰 豈	冫 豈
溰	水 豈	氵 豈
嘊	口 崖
敱	豈 攴
敳	豈 攴	豈 攵
皚	白 豈
癌	病 品 山	疒 品 山	疒 喦
騃	馬 矣
毐	士 母
昹	日 永
娾	女 厓
矮	矢 委
蔼	草 谒	艸 谒	艹 谒
躷	身 委
濭	水 蓋	氵 蓋
藹	草 謁	艸 謁	艹 謁
譪	言 葛	訁 葛
霭	雨 谒
靄	雨 謁
艾	草 乂	艸 乂	艹 乂
伌	人 厄	亻 厄
爱	爪 冖 友	爫 冖 友
砹	石 艾
硋	石 亥
隘	阜 益	阝 益
嗌	口 益
塧	土 益
嫒	女 爱
愛	爪 冖 心 夂	爫 冖 心 夂
碍	石 日 一 寸	石 㝵
叆	云 爱
暧	日 爱
瑷	玉 爱	王 爱
閡	門 亥
僾	人 愛	亻 愛
壒	土 蓋
嬡	女 愛
懓	心 愛	忄 愛
薆	草 愛	艸 愛	艹 愛
鴱	艾 鳥
懝	心 疑	忄 疑
曖	日 愛
璦	玉 愛	王 愛
餲	食 曷
皧	白 愛
瞹	目 愛
馤	香 曷
礙	石 疑
譺	言 疑	訁 疑
鑀	金 愛	釒 愛
靉	雲 愛
安	宀 女
侒	人 安	亻 安
峖	山 安
桉	木 安
氨	气 安
氨	氣 安	气 安
庵	广 奄
菴	草 奄	艸 奄	艹 奄
谙	言 音	讠 音
媕	女 弇
萻	草 音	艸 音	艹 音
葊	草 弇	艸 弇	艹 弇
痷	病 奄	疒 奄
腤	肉 音	月 音
鹌	奄 鸟
蓭	草 庵	艸 庵	艹 庵
誝	言 含	訁 含
鞌	安 革
鞍	革 安
盦	今 酉 皿
諳	言 音	訁 音
馣	香 奄
盫	合 酉 皿
鵪	奄 鳥
韽	酓 音
鶕	音 鳥
玵	玉 甘	王 甘
啽	口 弇
雸	雨 甘
儑	人 日 幺 幺 火	亻 日 幺 幺 灬	人 㬎	亻 㬎	日 幺 幺 灬
垵	土 安
俺	人 奄
唵	口 奄
埯	土 奄
铵	金 安	钅 安
隌	阜 音	阝 音
揞	手 音	扌 音	才 音
罯	网 音	罒 音
銨	金 安	釒 安
犴	犬 干	犭 干
岸	山 厈	山 厂 干
按	手 安	扌 安	才 安
洝	水 安	氵 安
荌	草 安	艸 安	艹 安
案	安 木
胺	肉 安	月 安
豻	豸 干
堓	土 岸
婩	女 岸
晻	日 奄
暗	日 音
貋	豸 旱
錌	金 岸	釒 岸
闇	門 音
鮟	魚 安
黯	黑 音
肮	肉 亢	月 亢
肮	月 亢	肉 亢
骯	骨 亢
卬	丿 𠄌 卩
岇	山 卬
昂	日 卬
昻	日 卬
枊	木 卬
盎	央 皿
醠	酉 盎
凹	凵 乛 丨 一
柪	木 幼
梎	木 皂
軪	車 幼
爊	火 麃
敖	土 方 攴	土 方 攵
厫	厂 敖
隞	阜 敖	阝 敖
嗷	口 敖
嗸	敖 口
嶅	敖 山
廒	广 敖
滶	水 敖	氵 敖
獓	犬 敖	犭 敖
蔜	草 敖	艸 敖	艹 敖
遨	辵 敖	辶 敖
摮	敖 手
熬	敖 火
獒	敖 犬
璈	玉 敖	王 敖
磝	石 敖
翱	皋 羽
聱	敖 耳
螯	敖 虫
螯	敖 蟲	敖 虫
謷	敖 言
謸	言 敖	訁 敖
翺	臯 羽
鳌	敖 鱼
鏖	鹿 金
鰲	敖 魚
鷔	敖 鳥
鼇	敖 黽
抝	手 幻	扌 幻	才 幻
芺	草 夭	艸 夭	艹 夭
拗	手 幼	扌 幼	才 幼
袄	衣 夭	衤 夭
镺	镸 夭
镺	長 夭	镸 夭
媪	女 昷
媼	女 昷
襖	衣 奧	衤 奧
岙	夭 山
扷	手 夭	扌 夭	才 夭
坳	土 幼
垇	土 凹
岰	山 幼
傲	人 敖
奡	一 自 夰
奡	一 自 夰	一 自 大 丿 丨
奥	丶 冂 米 大
奧	丶 冂 采 大	丶 冂 釆 大
嫯	敖 女
慠	心 敖	忄 敖
骜	敖 马
隩	阜 奧	阝 奧
墺	土 奧
嶴	奧 山
懊	心 奥
懊	心 奧
澳	水 奥	氵 奥
澳	水 奧	氵 奧
擙	手 奧	扌 奧	才 奧
鏊	敖 金
驁	敖 馬
丷	丶 丿
八	丿 乁
仈	人 八	亻 八
巴	巳 丨	巳 丶
叭	口 八
扒	手 八	扌 八	才 八
朳	木 八
玐	玉 八	王 八
夿	大 巴
岜	山 巴
芭	草 巴	艸 巴	艹 巴
峇	山 合
柭	木 犮
疤	病 巴	疒 巴
哵	口 別
捌	手 別	扌 別	才 別
笆	竹 巴
粑	米 巴
羓	羊 巴
蚆	虫 巴
蚆	蟲 巴	虫 巴
釛	金 力	釒 力
釟	金 八	釒 八
豝	豕 巴
鲃	鱼 巴
叐	丿 友
犮	一 丿 丶 又	一 丿 丶 乂	友 丶
抜	手 友	扌 友	才 友
坺	土 犮
妭	女 犮
拔	手 犮	扌 犮	才 犮
茇	草 犮	艸 犮	艹 犮
炦	火 犮
癹	癶 殳
胈	肉 犮	月 犮
菝	草 犮	艸 犮	艹 犮
詙	言 犮	訁 犮
跋	足 犮
軷	車 犮
颰	風 犮
魃	鬼 犮
墢	土 發
鼥	鼠 犮
把	手 巴	扌 巴
钯	金 巴	钅 巴
鈀	金 巴	釒 巴
靶	革 巴
坝	土 贝
弝	弓 巴
爸	父 巴
垻	土 貝
罢	网 去	罒 去
耙	耒 巴
跁	足 巴
鲅	鱼 犮
鲌	鱼 白
罷	网 能	罒 能
鮊	魚 白
覇	西 革 月	覀 革 月
矲	矢 罷
霸	雨 革 月
壩	土 霸
灞	水 霸	氵 霸
欛	木 霸
吧	口 巴
挀	手 厂 氏	扌 厂 氏	才 厂 氏	手 𠂢	扌 𠂢	才 𠂢
掰	手 分 手
擘	辟 手
白	丿 日	丶 日
百	一 白
佰	人 百	亻 百
柏	木 白
栢	木 百
捭	手 卑	扌 卑	才 卑
粨	米 百
絔	絲 百	糹 百	糸 百
摆	手 罢	扌 罢	才 罢
擺	手 罷	扌 罷	才 罷
襬	衣 罷	衤 罷
庍	广 斤
拝	手 一 丰	扌 一 丰	才 一 丰
败	贝 攴	贝 攵
拜	手 手
敗	貝 攴	貝 攵
猈	犬 卑	犭 卑
稗	禾 卑
粺	米 卑
贁	貝 貝 攴	貝 貝 攵
韛	韋 草 厂 用	韋 艸 厂 用	韋 艹 厂 用
扳	手 反	扌 反
攽	分 攴	分 攵
班	王 刂 王	玉 刂 王
般	舟 殳
颁	分 页
斑	王 文 王	玉 文 王
搬	手 般	扌 般	才 般
斒	文 扁
頒	分 頁
瘢	病 般	疒 般
鳻	分 鳥
螌	般 虫
螌	般 蟲	般 虫
褩	般 衣
癍	病 斑	疒 斑
辬	辛 文 辛
阪	阜 反	阝 反
坂	土 反
岅	山 反
昄	日 反
板	木 反
版	片 反
瓪	瓦 反
钣	金 反	钅 反
粄	米 反
舨	舟 反
鈑	金 反	釒 反
蝂	虫 版
蝂	蟲 版	虫 版
魬	魚 反
闆	門 品
办	力 八
半	丷 一 十	八 一 十
伴	人 半
扮	手 分	扌 分
坢	土 半
姅	女 半
怑	心 半	忄 半
拌	手 半	扌 半
绊	丝 半	纟 半
柈	木 半
秚	禾 半
湴	水 並	氵 並
絆	絲 半	糹 半	糸 半
鉡	金 半	釒 半
靽	革 半
辦	辛 力 辛
瓣	辛 瓜 辛
邦	丰 邑	丰 阝
垹	土 邦
帮	邦 巾
捠	手 兵	扌 兵	才 兵
梆	木 邦
浜	水 兵	氵 兵
邫	丰 邑
幇	封 巾
幚	邦 巾
縍	絲 旁	糹 旁	糸 旁
幫	封 帛
鞤	封 革
绑	丝 邦	纟 邦
綁	絲 邦	糹 邦	糸 邦
榜	木 旁
牓	片 旁
膀	肉 旁	月 旁
髈	骨 旁
玤	玉 丰	王 丰
蚌	虫 丰
蚌	蟲 丰	虫 丰
傍	人 旁
棒	木 奉
棓	木 咅	木 立 口
谤	言 旁	讠 旁
塝	土 旁
搒	手 旁	扌 旁	才 旁
稖	禾 咅
蒡	草 旁	艸 旁	艹 旁
蜯	虫 奉
蜯	蟲 奉	虫 奉
磅	石 旁
镑	金 旁	钅 旁
艕	舟 旁
謗	言 旁	訁 旁
鎊	金 旁	釒 旁
勹	丿 乛
包	勹 己
孢	子 包
苞	草 包	艸 包	艹 包
枹	木 包
胞	肉 包	月 包
笣	竹 包
煲	保 火
龅	齿 包
蕔	草 報	艸 報	艹 報
褒	保 衣	亠 保 衣
襃	衣 厂 二 呆
闁	門 門
齙	齒 包
窇	穴 包
嫑	不 要
雹	雨 包
薄	草 水 甫 寸	艸 氵 尃	艹 氵 尃
宝	宀 玉
怉	心 包	忄 包
饱	食 包	饣 包
保	人 呆	亻 呆
鸨	匕 十 鸟	𠤏 鸟
宲	宀 呆
珤	玉 缶	王 缶
堡	保 土
堢	土 保
葆	草 保	艸 保	艹 保
寚	宀 王 缶
飹	食 卯
飽	食 包	飠 包
褓	衣 保	衤 保
駂	馬 匕 十	馬 𠤏
鳵	卂 鳥
緥	絲 保	糹 保	糸 保
鴇	匕 十 鳥	𠤏 鳥
賲	保 貝
寳	宀 王 尔 貝
寶	宀 王 缶 貝	宀 玉 缶 貝
靌	雨 寶
勽	勹 人
报	手 卩 又	扌 卩 又	才 卩 又
抱	手 包	扌 包
豹	豸 勺
趵	足 勺
铇	金 包	钅 包
菢	草 抱	艸 抱	艹 抱
蚫	虫 包
蚫	蟲 包	虫 包
袌	亠 衣 包
袌	衣 包
報	幸 卩 又
鉋	金 包	釒 包
鲍	鱼 包
靤	面 包
骲	骨 包
暴	日 共 水	日 恭
髱	髟 包
虣	武 虎
鮑	魚 包
儤	人 暴	亻 暴
曓	日 出 大 本
爆	火 暴
忁	彳 日 出 大 水
鑤	金 暴	釒 暴
陂	阜 皮	阝 皮
卑	丶 田 丿 十
杯	木 不
盃	不 皿
桮	木 否
悲	非 心
揹	手 背	扌 背	才 背
椑	木 卑
碑	石 卑
鹎	卑 鸟
藣	草 罷	艸 罷	艹 罷
鵯	卑 鳥
北	丬 匕
鉳	金 北	釒 北
贝	冂 人
孛	十 冖 子
狈	犬 贝	犭 贝
貝	目 八
邶	北 邑	北 阝
备	夂 田
昁	日 巿
牬	牛 丿 乛 丨 丿	牜 丿 乛 丨 丿	牛 𠂔	牜 𠂔
苝	草 北	艸 北	艹 北
背	北 肉	北 月
郥	貝 邑	貝 阝
钡	金 贝	钅 贝
俻	人 备	亻 备
倍	人 咅	亻 咅	人 立 口	亻 立 口
悖	心 孛	忄 孛
狽	犬 貝	犭 貝
被	衣 皮	衤 皮
偝	人 背	亻 背
偹	攸 田	人 丨 备	亻 丨 备
梖	木 貝
珼	玉 貝	王 貝
鄁	背 邑	背 阝
備	人 草 厂 用	亻 艹 厂 用	亻 井 厂 用
僃	人 草 勹 用	人 艸 勹 用	亻 艹 勹 用
惫	备 心
焙	火 咅
琲	玉 非	王 非
軰	北 車
辈	非 车
愂	勃 心
碚	石 咅
蓓	草 倍	艸 倍	艹 倍
蛽	蟲 貝	虫 貝
犕	牛 人 草 厂 用	牜 艹 厂 用	牛 井 厂 用
褙	衣 背	衤 背
誖	言 孛	訁 孛
鞁	革 皮
骳	骨 皮
輩	非 車
鋇	金 貝	釒 貝
憊	備 心
糒	米 草 厂 用	米 艹 厂 用
鞴	革 草 厂 用	革 艸 厂 用	革 艹 厂 用
鐾	辟 金
呗	口 贝
唄	口 貝
奔	大 卉
泍	水 本	氵 本
贲	十 艹 贝
栟	木 并
栟	木 并	木 幷
犇	牛 牛 牛
锛	金 奔	钅 奔
錛	金 奔	釒 奔
本	木 一
苯	草 本	艸 本	艹 本
奙	厶 大 电
畚	厶 大 田
翉	本 羽
楍	木 口 口 口
坋	土 分
坌	土 分
倴	人 奔	亻 奔
捹	手 奔	扌 奔	才 奔
桳	木 厶 大 十
渀	水 奔	氵 奔
笨	竹 本
逩	辵 奔	辶 奔
撪	手 厶 大 車	扌 厶 大 車	才 厶 大 車
獖	犬 賁	犭 賁
輽	車 畚
伻	人 平	亻 平
祊	示 方	礻 方
奟	大 朋
崩	山 朋
绷	丝 朋	纟 朋
絣	絲 并	糹 并	糸 并	絲 幷	糹 幷	糸 幷
閍	門 方
傰	人 崩	亻 崩
嵭	山 旁
痭	病 朋	疒 朋
嘣	口 朋
綳	絲 朋	糹 朋	糸 朋
甭	不 用
埄	土 夆
埲	土 奉
菶	草 奉	艸 奉	艹 奉
琣	玉 咅	王 咅
琫	玉 奉	王 奉
繃	絲 崩	糹 崩	糸 崩
鞛	革 咅
泵	石 水
迸	辵 并	辶 并
迸	辵 并	辶 并	辵 幷	辶 幷
逬	辵 幷	辶 幷
塴	土 朋
甏	彭 瓦
镚	金 朋	钅 朋
蹦	足 崩
鏰	金 朋	釒 朋
揼	手 泵	扌 泵	才 泵
屄	尸 穴
偪	人 畐	亻 畐
毴	毛 非
逼	辵 畐	辶 畐
楅	木 畐
豍	豆 卑
螕	虫 囟 比
螕	蟲 囟 比	虫 囟 比
鵖	皂 鳥
鲾	鱼 畐
鎞	金 囟 比	釒 囟 比
鰏	魚 畐
荸	草 孛	艸 孛	艹 孛
鼻	自 田 廾
匕	乚 丿
比	匕 匕
夶	大 大
朼	木 匕
佊	人 皮	亻 皮
吡	口 比
妣	女 比
沘	水 比	氵 比
疕	病 匕	疒 匕
彼	彳 皮
柀	木 皮
秕	禾 比
俾	人 卑	亻 卑
笔	竹 毛
粃	米 比
舭	舟 比
啚	口 亠 回
筆	竹 聿
鄙	啚 邑	啚 阝
箄	竹 卑
聛	耳 卑
貏	豸 卑
币	丿 巾
必	心 丿
毕	比 十
闭	门 才
佖	人 必	亻 必
坒	比 土
庇	广 比
诐	言 皮	讠 皮
邲	必 邑	必 阝
妼	女 必
怭	心 必	忄 必
怶	心 皮	忄 皮
枈	比 木
畀	田 丌
畁	由 丌
苾	草 必	艸 必	艹 必
哔	口 毕
柲	木 必
毖	比 必
珌	玉 必	王 必
疪	病 必	疒 必
荜	草 毕	艸 毕	艹 毕
陛	阜 坒	阝 坒	阜 比 土	阝 比 土
毙	比 死
狴	犬 比 土	犭 比 土
畢	田 艹 一 十
笓	竹 比
粊	比 米
袐	衣 必	衤 必
铋	金 必	钅 必
婢	女 卑
庳	广 卑
敝	丷 巾 八 攴	丷 巾 八 攵	㡀 攴	㡀 攵
梐	木 坒	木 比 土
萆	草 卑	艸 卑	艹 卑
閇	門 下
閉	門 才
堛	土 畐
弻	弓 丙 一 弓
弼	弓 百 弓
愊	心 畐	忄 畐
愎	心 复	忄 复
湢	水 畐	氵 畐
皕	百 百
禆	示 卑	礻 卑
筚	竹 毕
詖	言 皮	訁 皮
貱	貝 皮
賁	十 十 十 貝
赑	贝 贝 贝
嗶	口 畢
彃	弓 畢
滗	水 笔	氵 笔
滭	水 畢	氵 畢
煏	火 畐
痹	病 畀	疒 畀
痺	病 卑	疒 卑
睤	目 畀
腷	肉 畐	月 畐
蓖	草 囟 比	艸 囟 比	艹 囟 比
蓽	草 畢	艸 畢	艹 畢
蜌	虫 比 土
蜌	蟲 比 土	虫 比 土
裨	衣 卑	衤 卑
跸	足 毕
鉍	金 必	釒 必
閟	門 必
飶	食 必
幣	敝 巾
弊	敝 廾
熚	火 畢
獙	犬 敝	犭 敝
碧	王 白 石
箅	竹 畀
箆	内 比
箆	竹 內 比
綼	絲 卑	糹 卑	糸 卑
蔽	草 敝	艸 敝	艹 敝
鄪	費 邑	費 阝
馝	香 必
潷	水 筆	氵 筆
獘	敝 犬
罼	网 畢	罒 畢
駜	馬 必
髲	髟 皮
壁	辟 土
嬖	辟 女
廦	广 辟
篦	竹 囟 比
篳	竹 畢
縪	絲 畢	糹 畢	糸 畢
薜	草 辟	艸 辟	艹 辟
觱	咸 角
避	辵 辟	辶 辟
鮅	魚 必
斃	敝 死
濞	水 鼻	氵 鼻
臂	肉 辟	月 辟
蹕	足 畢
髀	骨 卑
奰	目 目 目 大	罒 罒 罒 大
璧	辟 玉
鄨	敝 邑
鏎	金 畢	釒 畢
饆	食 畢
繴	辟 糸
襞	辟 衣
襣	衣 鼻	衤 鼻
鞸	革 畢
韠	韋 畢
魓	鬼 畢
躃	足 辟
躄	辟 足
驆	馬 畢
贔	貝 貝 貝
鐴	金 辟	釒 辟
鷝	畢 鳥
鷩	敝 鳥
鼊	辟 黽
边	辵 力	辶 力
辺	辵 刀	辶 刀
砭	石 乏
笾	竹 边
揙	手 扁	扌 扁	才 扁
猵	犬 扁	犭 扁
编	丝 扁	纟 扁
煸	火 扁
牑	片 扁
甂	扁 瓦
箯	竹 便
編	絲 扁	糹 扁	糸 扁
蝙	虫 扁
蝙	蟲 扁	虫 扁
獱	犬 賓	犭 賓
邉	辵 自 冖 八 口	辶 自 冖 八 口
鍽	金 扁	釒 扁
鳊	鱼 扁
邊	辵 自 穴 方	辶 自 穴 方	辵 臱	辶 臱
鞭	革 便
鯾	魚 便
鯿	魚 扁
籩	竹 邊
贬	贝 乏
扁	戶 冊	户 冊	戸 冊
窆	穴 乏
匾	匚 扁	匚 扁
貶	貝 乏
惼	心 扁	忄 扁
萹	草 扁	艸 扁	艹 扁
碥	石 扁
稨	禾 扁
褊	衣 扁	衤 扁
糄	米 扁
鴘	弁 鳥
藊	草 稨	艸 稨	艹 稨
卞	丶 下
弁	厶 廾
忭	心 卞	忄 卞
抃	手 卞	扌 卞	才 卞
汳	水 反	氵 反
汴	水 卞	氵 卞
苄	草 卞	艸 卞	艹 卞
釆	丿 米
变	亦 又
玣	玉 卞	王 卞
便	人 更	亻 更
変	亦 夂
昪	日 弁
覍	小 見
徧	彳 扁
缏	丝 便	纟 便
遍	辵 扁	辶 扁
閞	門 弁
辡	辛 辛
緶	絲 便	糹 便	糸 便
艑	舟 扁
辧	辛 刀 辛
辨	辛 丶 丿 辛
辩	辛 言 辛	辛 讠 辛
辫	辛 丝 辛	辛 纟 辛
辮	辛 絲 辛	辛 糸 辛
辯	辛 言 辛	辛 訁 辛
變	絲 言 夕	糸 言 糸 夕	絲 言 夂	䜌 夕	䜌 夂
灬	丶 丶 丶 丶
杓	木 勺
标	木 示
飑	风 包
骉	马 马 马
髟	镸 彡
淲	水 虎	氵 虎
彪	虎 彡
猋	犬 犬 犬
脿	肉 表	月 表
颩	風 彡
墂	土 票
幖	巾 票
摽	手 票	扌 票	才 票
滮	水 彪	氵 彪
蔈	草 票	艸 票	艹 票
颮	風 包
骠	马 票
標	木 票
熛	火 票
膘	肉 票	月 票
瘭	病 票	疒 票
磦	石 票
镖	金 票	钅 票
飙	猋 风	犬 犬 犬 风
飚	风 猋
儦	人 麃	亻 麃
颷	風 炎
瀌	水 麃	氵 麃
藨	草 麃	艸 麃	艹 麃
謤	言 票	訁 票
爂	臼 同 冖 火
臕	肉 麃	月 麃
贆	貝 猋
鏢	金 票	釒 票
穮	禾 麃
镳	金 鹿 灬	钅 鹿 灬
飆	猋 風	犬 犬 犬 風
飇	風 猋
飈	風 焱
驃	馬 票
鑣	金 麃	釒 麃
驫	馬 馬 馬
表	丰 衣
表	丰 衣
婊	女 表
裱	衣 表	衤 表
諘	言 表	訁 表
褾	衣 票	衤 票
錶	金 表	釒 表
檦	木 剽
俵	人 表	亻 表
鳔	鱼 票
鰾	魚 票
憋	敝 心
蟞	敝 虫
蟞	敝 蟲	敝 虫
鳖	鱼 敝
鱉	魚 敝
鼈	敝 黽
虌	草 鼈	艸 鼈	艹 鼈	蔽 黽
龞	敝 龜
別	口 刀 刀	口 刀 刀 刂
别	另 刀	另 刂
咇	口 必
莂	草 別	艸 別	艹 別	草 别	艸 别	艹 别
蛂	虫 犮
蛂	蟲 犮	虫 犮
徶	彳 敝
襒	衣 敝	衤 敝
蹩	敝 足
瘪	病 自 仑	疒 自 仑
癟	病 自 侖	疒 自 侖
彆	敝 弓
汃	水 八	氵 八
邠	分 邑	分 阝
玢	玉 分	王 分
砏	石 分
宾	宀 兵
彬	林 彡
梹	木 兵
傧	人 宾	亻 宾
斌	文 武
椕	林 分	木 分 木
滨	水 宾	氵 宾
缤	丝 宾	纟 宾
槟	木 宾
瑸	玉 宾	王 宾
豩	豕 豕
賓	宀 一 少 貝
賔	宀 眉 八
镔	金 宾	钅 宾
儐	人 賓	亻 賓
濒	水 频	氵 频
濱	水 賓	氵 賓
虨	虎 彬	虍 彬	虎 林 彡	虍 林 彡
豳	山 豩	豕 山 豕
檳	木 賓
璸	玉 賓	王 賓
瀕	水 頻	氵 頻
霦	雨 彬
繽	絲 賓	糹 賓	糸 賓
鑌	金 賓	釒 賓
顮	賓 頁
摈	手 宾	扌 宾	才 宾
殡	歹 宾
膑	肉 宾	月 宾
髩	髟 丏
擯	手 賓	扌 賓	才 賓
鬂	髟 兵
殯	歹 賓
臏	肉 賓	月 賓
髌	骨 宾
鬓	髟 宾
髕	骨 賓
鬢	髟 賓
冫	丶 丿
仌	人 人
仒	人 冰	人 冫	人 丶 丶
氷	丶 水
冰	冫 水
兵	丘 八
掤	手 朋	扌 朋	才 朋
丙	一 人 冂
邴	丙 邑	丙 阝
陃	阜 丙	阝 丙
怲	心 丙	忄 丙
抦	手 丙	扌 丙	才 丙
秉	禾 聿	禾 肀	丿 一 彐 丨 丿 乀
苪	草 丙	艸 丙	艹 丙
昞	日 丙
昺	日 丙
柄	木 丙
炳	火 丙
饼	饣 并
饼	食 并	饣 并
眪	目 丙
窉	穴 丙
蛃	虫 丙
蛃	蟲 丙	虫 丙
摒	手 屏	扌 屏	才 屏
棅	木 秉
禀	亠 回 示
稟	亠 回 禾
鈵	金 丙	釒 丙
鉼	金 并	釒 并	金 幷	釒 幷
餅	食 并	飠 并	食 幷	飠 幷
餠	食 幷	飠 幷	食 并	飠 并
鞞	革 卑
并	丷 开
並	丷 亚	丷 一 业
併	人 并	亻 并
併	人 并	亻 并	人 幷	亻 幷
庰	广 并
庰	广 并	广 幷
倂	人 幷	亻 幷
栤	木 冰
病	疒 丙
竝	立 立
偋	人 屏	亻 屏
傡	人 竝	亻 竝
傡	人 竝	亻 竝	人 立 立	亻 立 立
寎	宀 爿 丙
誁	言 并	訁 并	言 幷	訁 幷
鮩	魚 并	魚 幷
靐	雷 雷 雷
帗	巾 犮
拨	手 发	扌 发	才 发
波	水 皮	氵 皮
玻	玉 皮	王 皮
剝	彔 刀	彔 刂
剥	录 刀	录 刂
哱	口 孛
盋	犮 皿
砵	石 本
袚	衣 犮	衤 犮
钵	金 本	钅 本
饽	饣 孛
啵	口 波
紴	絲 皮	糹 皮	糸 皮
缽	缶 本
菠	草 波	艸 波	艹 波
碆	波 石
鉢	金 本	釒 本
僠	人 番	亻 番
嶓	山 番
撥	手 發	扌 發	才 發
播	手 番	扌 番	才 番
餑	食 孛
鮁	魚 犮
蹳	足 發
驋	馬 發
鱍	魚 發
仢	人 勺	亻 勺
伯	人 白	亻 白
犻	犬 巿	犭 巿
肑	肉 勺	月 勺
驳	马 爻
帛	白 巾
狛	犬 白	犭 白
瓝	瓜 勺
苩	草 白	艸 白	艹 白
侼	人 孛	亻 孛
勃	孛 力
胉	肉 白	月 白
郣	孛 邑	孛 阝
亳	亠 口 冂 乇
亳	亠 口 冖 乇
挬	手 孛	扌 孛	才 孛
浡	水 孛	氵 孛
瓟	瓜 包
秡	禾 犮
袯	衣 发	衤 发
钹	金 犮	钅 犮
铂	金 白	钅 白
淿	水 帛	氵 帛
脖	肉 孛	月 孛
舶	舟 白
袹	衣 百	衤 百
博	十 尃	十 甫 寸
渤	水 勃	氵 勃
葧	草 勃	艸 勃	艹 勃
鹁	孛 鸟
愽	心 尃	忄 尃
搏	手 尃	扌 尃	才 尃	手 甫 寸
猼	犬 尃	犭 尃
鈸	金 犮	釒 犮
鉑	金 白	釒 白
馎	饣 尃
僰	棘 人
煿	火 尃
牔	片 尃
箔	竹 泊
膊	肉 尃	月 尃
艊	舟 帛
蔔	草 匐	艸 匐	艹 匐
馛	香 犮
駁	馬 爻
踣	足 咅
鋍	金 孛	釒 孛
镈	金 尃	钅 尃
馞	香 孛
駮	馬 交
襏	衣 發	衤 發
豰	士 冡 殳
嚗	口 暴
懪	心 暴	忄 暴
礡	石 蒪
簙	竹 博
鎛	金 尃	釒 尃
餺	食 尃
鵓	孛 鳥
犦	牛 暴	牜 暴
髆	骨 尃
髉	骨 隺
欂	木 薄
襮	衣 暴	衤 暴
礴	石 薄
鑮	金 薄	釒 薄
跛	足 皮
箥	竹 波
簸	竹 其 皮
孹	辟 子
檗	辟 木
糪	辟 米
譒	言 番	訁 番
蘗	草 檗	艸 檗	艹 檗
卜	丨 丶
峬	山 甫
庯	广 甫
逋	辵 甫	辶 甫
钸	金 布	钅 布
晡	日 甫
鈽	金 布	釒 布
誧	言 甫	訁 甫
鳪	卜 鳥
轐	車 菐
醭	酉 菐
卟	口 卜
补	衣 卜	衤 卜
哺	口 甫
捕	手 甫	扌 甫	才 甫
補	衣 甫	衤 甫
鵏	甫 鳥
鸔	鳥 暴
不	一 丿 丨 丶
布	一 丿 巾
佈	人 布	亻 布
吥	口 不
步	止 小	止 亅 丶 丿	止 少
咘	口 布
怖	心 布	忄 布
抪	手 布	扌 布	才 布
歨	止 卜 人
歩	止 少
钚	金 不	钅 不
勏	咅 力
埔	土 甫
埗	土 步
悑	心 甫	忄 甫
捗	手 步	扌 步	才 步
荹	草 步	艸 步	艹 步
部	咅 邑	咅 阝
埠	土 阜
瓿	咅 瓦
廍	广 部
蔀	草 部	艸 部	艹 部
踄	足 步
郶	咅 邑
餔	食 甫
篰	竹 部
餢	食 咅
簿	竹 薄
嚓	口 察
擦	手 察	扌 察	才 察
攃	手 蔡	扌 蔡	才 蔡
礤	石 蔡
礸	石 贊
遪	辵 參	辶 參
囃	口 雜
偲	人 思	亻 思
猜	犬 青	犭 靑
才	一 亅 丿
材	木 才
财	贝 才
財	貝 才
裁	十 戈 衣	土 戈 衣	𢦏 衣
纔	絲 毚	糹 毚	糸 毚
采	爪 木	爫 木
倸	人 采	亻 采
啋	口 采
婇	女 采
寀	宀 采
彩	采 彡
採	手 采	扌 采	才 采
睬	目 采
跴	足 西
綵	絲 采	糹 采	糸 采
踩	足 采
埰	土 采
菜	草 采	艸 采	艹 采
棌	木 采
蔡	草 祭	艸 祭	艹 祭
縩	絲 祭	糹 祭	糸 祭
参	厶 大 彡
參	厽 人 彡	厶 厶 厶 人 彡
叄	厽 人 三	厶 厶 厶 人 三
飡	冰 食	冫 食
骖	马 参
叅	厽 人 心	厽 人 小 丶
喰	口 食
湌	水 食	氵 食
傪	人 參	亻 參
嬠	女 喿
餐	歹 又 食	歺 又 食
驂	馬 參
残	歹 戋
蚕	天 虫
惭	心 斩	忄 斩
殘	歹 戔
慚	心 斬	忄 斬
蝅	天 天 虫
蝅	天 天 蟲	天 天 虫
慙	斬 心
蠶	旡 旡 日 蟲 蟲	旡 旡 日 虫 虫	朁 蟲 蟲	朁 虫 虫
蠺	天 天 日 蟲 蟲	天 天 日 虫 虫
惨	心 参	忄 参
朁	兓 日
朁	兓 日	旡 旡 日
慘	心 參	忄 參
憯	心 朁	忄 朁
穇	禾 參
篸	竹 參
黪	黑 参
黲	黑 參
灿	火 山
掺	手 参	扌 参	才 参
孱	尸 孨	尸 子 子 子
粲	歹 又 米	歺 又 米
摻	手 參	扌 參	才 參
澯	水 粲	氵 粲
薒	草 粲	艸 粲	艹 粲
燦	火 粲
璨	玉 粲	王 粲
謲	言 參	訁 參
仓	人 卩	人 㔾
仺	人 匚 一
伧	人 仓	亻 仓
沧	水 仓	氵 仓
苍	草 仓	艸 仓	艹 仓
鸧	仓 鸟
倉	人 尸 一 口
舱	舟 仓
傖	人 倉	亻 倉
嵢	山 倉
滄	水 倉	氵 倉
獊	犬 倉	犭 倉
蒼	草 倉	艸 倉	艹 倉
艙	舟 倉
螥	蟲 倉	虫 倉
鶬	倉 鳥
藏	草 臧	艸 臧	艹 臧
鑶	金 藏	釒 藏
賶	貝 倉
撡	手 叅	扌 叅	才 叅
操	手 品 木	扌 品 木	才 品 木	扌 喿
糙	米 造
曺	一 由 曰	一 由 日
曹	卄 曰 日	一 丨 丨 曰 日
嘈	口 曹
嶆	山 曹
漕	水 曹	氵 曹
蓸	草 曹	艸 曹	艹 曹
槽	木 曹
褿	衣 曹	衤 曹
艚	舟 曹
螬	虫 曹
螬	蟲 曹	虫 曹
鏪	金 曹	釒 曹
艸	屮 屮	山 山
草	艸 早	艹 早
愺	心 草	忄 草
懆	心 喿	忄 喿
騲	馬 草
肏	入 肉
鄵	喿 邑	喿 阝
襙	衣 喿	衤 喿
艹	一 丨 丨
冊	冂 一 丨 丨
册	几 几 一
侧	人 则	亻 则
厕	厂 则
恻	心 则	忄 则
拺	手 朿	扌 朿	才 朿
测	水 则	氵 则
荝	草 则	艸 则	艹 则
敇	朿 攴	朿 攵
畟	田 八 夂
側	人 則	亻 則
笧	竹 册
粣	米 冊
萗	草 宗	艸 宗	艹 宗
廁	广 則
惻	心 則	忄 則
測	水 則	氵 則
策	竹 朿
萴	草 則	艸 則	艹 則
筞	竹 宋
筴	竹 夾
蓛	草 敇	艸 敇	艹 敇
墄	土 戚
箣	竹 刺
憡	心 策	忄 策
簎	竹 措
嵾	山 參
岑	山 今
涔	水 岑	氵 岑
笒	竹 今
梣	木 岑
曽	丷 田 曰	丷 田 日
噌	口 曽	口 曾
层	尸 云
曾	丷 口 丨 丷 曰	八 口 丨 丷 曰
層	尸 曽	尸 曾
嶒	山 曾
竲	立 曾
驓	馬 曾
蹭	足 曾
叉	又 丶
扠	手 叉	扌 叉	才 叉
杈	木 叉
肞	肉 义	月 义
臿	千 臼	干 臼
偛	人 臿	亻 臿
嗏	口 茶
插	手 臿	扌 臿	才 臿	手 千 臼
揷	手 千 臼	扌 千 臼	才 千 臼
馇	饣 查
銟	金 山 巾	釒 山 巾
锸	金 臿	钅 臿
艖	舟 差
疀	甾 疌
鍤	金 臿	釒 臿
餷	食 查
秅	禾 乇
垞	土 宅
查	木 旦
茬	草 在	艸 在	艹 在
茶	草 人 一 小	艸 人 一 小	艹 人 一 小
嵖	山 查
搽	手 茶	扌 茶	才 茶
猹	犬 查	犭 查
靫	革 叉
槎	木 差
詧	夗 言
察	宀 祭
碴	石 查
檫	木 察
衩	衣 叉	衤 叉
蹅	足 查
镲	金 察	钅 察
鑔	金 察	釒 察
奼	女 乇
汊	水 叉	氵 叉
岔	分 山
侘	人 宅	亻 宅
诧	言 宅	讠 宅
姹	女 宅
差	羊 工
差	羊 丿 工
紁	絲 义	糹 义	糸 义
詫	言 宅	訁 宅
芆	草 叉	艸 叉	艹 叉
拆	手 斥	扌 斥	才 斥
钗	金 叉	钅 叉
釵	金 叉	釒 叉
犲	犬 才	犭 才
侪	人 齐	亻 齐
柴	此 木
豺	豸 才
祡	此 示
喍	口 柴
儕	人 齊	亻 齊
齜	齒 此
茝	草 臣	艸 臣	艹 臣
虿	万 虫
袃	切 衣
訍	言 叉	訁 叉
瘥	病 差	疒 差
蠆	萬 蟲	萬 虫
囆	口 蠆
辿	辵 山	辶 山
觇	占 见
梴	木 延
搀	手 免 冫	扌 免 冫	才 免 冫
覘	占 見
裧	衣 炎	衤 炎
鉆	金 占	釒 占
鋓	金 利	釒 利
幨	巾 詹
襜	衣 詹	衤 詹
攙	手 毚	扌 毚	才 毚
婵	女 单
谗	言 免 冫	讠 免 冫
棎	木 穼
湹	水 厘	氵 厘
禅	示 单	礻 单
馋	食 免 冫	饣 免 冫
煘	火 咸
缠	丝 广 里	纟 广 里
缠	丝 厘	纟 厘
僝	人 孱	亻 孱
獑	犬 斬	犭 斬
蝉	虫 单
誗	言 利	訁 利
鋋	金 延	釒 延
儃	人 亶	亻 亶
嬋	女 單
廛	广 里 儿 土
潹	水 森	氵 森
潺	水 孱	氵 孱
緾	絲 厘	糹 厘	糸 厘
澶	水 亶	氵 亶
磛	斬 石
禪	示 單	礻 單
毚	刀 口 比 兔
毚	刀 口 比 兔	㲋 兔
鄽	廛 邑	廛 阝
镡	金 覃	钅 覃
瀍	水 廛	氵 廛
蟬	蟲 單	虫 單
儳	人 毚	亻 毚
劖	毚 刀	毚 刂
蟾	虫 詹
蟾	蟲 詹	虫 詹
酁	毚 邑	毚 阝
嚵	口 毚
巉	山 毚
瀺	水 毚	氵 毚
欃	木 毚
纏	絲 广 里 儿 土	糹 广 里 儿 土	糸 广 里 儿 土
纒	絲 广 黒 土	糹 广 黒 土	糸 广 黒 土
躔	足 廛
镵	金 毚	钅 毚
艬	舟 毚
讒	言 毚	訁 毚
鑱	金 毚	釒 毚
饞	食 毚	飠 毚
产	立 丿
刬	戋 刀	戋 刂
旵	日 山
丳	串 丿
斺	方 丿 一 介
浐	水 产	氵 产
剗	戔 刀	戔 刂
谄	言 臽	讠 臽
啴	口 单
產	产 生	文 厂 生
産	产 生	立 丿 生
铲	金 产	钅 产
阐	门 单
蒇	草 戊 贝	艸 戊 贝	艹 戊 贝
嵼	山 產
摌	手 產	扌 產	才 產
滻	水 產	氵 產
嘽	口 單
幝	巾 單
蕆	草 戊 貝	艸 戊 貝	艹 戊 貝
諂	言 臽	訁 臽
閳	門 車
骣	马 孱
燀	火 單
簅	竹 產
冁	单 展
繟	絲 單	糹 單	糸 單
譂	言 單	訁 單
辴	單 辰
鏟	金 產	釒 產
闡	門 單
囅	單 展
灛	水 闡	氵 闡
讇	言 閻	訁 閻
忏	心 千	忄 千
硟	石 延
摲	手 斬	扌 斬	才 斬
懴	心 千	忄 千
懴	心 韯	忄 韯
颤	亶 页
懺	心 韱	忄 韱
羼	尸 羴
韂	革 詹
顫	亶 頁
伥	人 长	亻 长
昌	日 曰	日 日
倀	人 長	亻 長
娼	女 昌
淐	水 昌	氵 昌
猖	犬 昌	犭 昌
菖	草 昌	艸 昌	艹 昌
阊	门 昌
晿	日 昌
琩	玉 昌	王 昌
裮	衣 昌	衤 昌
锠	金 昌	钅 昌
錩	金 昌	釒 昌
閶	門 昌
鲳	鱼 昌
鯧	魚 昌
鼚	鼓 長
仧	上 人
兏	厂 上 儿
肠	肉 弓 丿 丿	月 弓 丿 丿
苌	草 长	艸 长	艹 长
镸	三 丨 一 厶
尝	小 冖 云
偿	人 尝	亻 尝
常	尚 巾
徜	彳 尚
瓺	镸 瓦
萇	草 長	艸 長	艹 長
甞	尚 甘
腸	肉 昜	月 昜
嘗	尚 旨
塲	土 人 丿 一 昜
嫦	女 常
瑺	玉 常	王 常
膓	肉 丿 一 昜	月 丿 一 昜
鋿	金 尚	釒 尚
償	人 賞	亻 賞
嚐	口 嘗
鲿	鱼 尝
鏛	金 常	釒 常
鱨	魚 嘗
厂	一 丿
场	土 弓 丿 丿
昶	永 日
惝	心 尚	忄 尚
場	土 昜
敞	尚 攴	尚 攵
僘	人 敞	亻 敞
厰	厂 敞
廠	广 敞
氅	敞 毛
鋹	金 長	釒 長
怅	心 长	忄 长
玚	玉 弓 丿 丿	王 弓 丿 丿
畅	申 弓 丿 丿
倡	人 昌	亻 昌
鬯	凵 乂 丶 丶 丶 丶 匕
唱	口 昌
悵	心 長	忄 長
焻	火 昌
瑒	玉 昜	王 昜
暢	申 昜
畼	田 昜
誯	言 昌	訁 昌
韔	韋 長
抄	手 少	扌 少	才 少
弨	弓 召
怊	心 召	忄 召
欩	召 欠
钞	金 少	钅 少
訬	言 少	訁 少
焯	火 卓
超	走 召
鈔	金 少	釒 少
勦	巢 力
牊	片 召
晁	日 兆
巢	巛 果
巣	小 果	丶 丶 丶 果
朝	十 日 十 月	卓 月	車 月
鄛	巢 邑	巢 阝
鼌	旦 黾
漅	水 巢	氵 巢
嘲	口 朝
樔	木 巢
潮	水 朝	氵 朝
窲	穴 料
罺	网 巢	罒 巢
轈	車 巢
鼂	旦 黽
謿	言 朝	訁 朝
吵	口 少
炒	火 少
眧	目 召
焣	取 火	取 灬
煼	火 芻
麨	麥 少
巐	山 高 昇
仦	人 小	亻 小
仯	人 少	亻 少
耖	耒 少
觘	角 少
车	一 𠃋 十
伡	人 车	亻 车
車	一 日 十
俥	人 車	亻 車
砗	石 车
唓	口 車
莗	草 車	艸 車	艹 車
硨	石 車
蛼	蟲 車	虫 車
扯	手 止	扌 止	才 止
偖	人 者	亻 者
撦	手 奢	扌 奢	才 奢
屮	凵 丨
彻	彳 切
坼	土 斥
迠	辵 占	辶 占
烢	火 宅
聅	耳 矢
掣	制 手
硩	折 石
頙	正 頁
徹	彳 育 攵
撤	手 育 攵	扌 育 攵	才 育 攵
澈	水 育 攵	氵 育 攵
勶	徹 力
瞮	目 育 攴	目 育 攵
爡	火 蠆
抻	手 申	扌 申	才 申
郴	林 邑	林 阝
捵	手 典	扌 典	才 典
琛	玉 罙	王 罙
嗔	口 真
綝	絲 林	糹 林	糸 林
瞋	目 真
諃	言 林	訁 林
賝	貝 罙
縝	絲 真	糹 真	糸 真
謓	言 真	訁 真
尘	小 土
臣	巨 丨 丨	巨 丶 丶
忱	心 冘	忄 冘
沉	氵 冗
辰	厂 衣
陈	阜 东	阝 东
迧	辵 申	辶 申
茞	草 臣	艸 臣	艹 臣
宸	宀 辰
莀	草 辰	艸 辰	艹 辰
莐	草 沈	艸 沈	艹 沈
陳	阜 東	阝 東
敐	辰 攴	辰 攵
晨	日 辰
訦	言 冘	訁 冘
谌	言 甚	讠 甚
軙	車 攴	車 攵
愖	心 甚	忄 甚
揨	手 亭	扌 亭	才 亭
鈂	金 冘	釒 冘
煁	火 甚
蔯	草 陳	艸 陳	艹 陳
塵	鹿 土
樄	木 陳
瘎	病 甚	疒 甚
霃	雨 沈
螴	陳 蟲	陳 虫
諶	言 甚	訁 甚
薼	草 塵	艸 塵	艹 塵
麎	鹿 辰
曟	晶 辰
鷐	晨 鳥
趻	足 今
硶	石 岑
碜	石 参
墋	土 參
夦	甚 多
磣	石 參
踸	足 甚
鍖	金 甚	釒 甚
贂	貝 參
醦	酉 參
衬	衣 寸	衤 寸
疢	病 火	疒 火
龀	齿 匕
趁	走 人 彡
趂	走 尔
榇	木 亲
齓	齒 乚
齔	齒 匕
儭	人 親	亻 親
嚫	口 親
谶	言 韱	讠 韱
櫬	木 親
襯	衣 親	衤 親
讖	言 韱	訁 韱
阷	阜 正	阝 正
泟	水 正	氵 正
柽	木 圣
爯	爪 冉	爫 冉
棦	木 爭
浾	水 赤	氵 赤
琤	玉 爭	王 爭
称	禾 尔
偁	人 爯	亻 爯
蛏	虫 圣
湞	水 貞	氵 貞
牚	尚 牙
赪	赤 贞
僜	人 登	亻 登
憆	心 堂	忄 堂
摚	手 堂	扌 堂	才 堂
稱	禾 爯	禾 爪 冉	禾 爫 冉
靗	青 光
撐	手 牚	扌 牚	才 牚	手 尚 牙
撑	手 掌	扌 掌	才 掌	手 尚 手
緽	絲 貞	糹 貞	糸 貞
橕	木 牚
瞠	目 堂
赬	赤 貞
頳	赤 頁
檉	木 聖
竀	穴 正 見
罉	缶 掌
穪	禾 爾
蟶	蟲 聖	虫 聖
鏳	金 曾	釒 曾
鏿	金 棠	釒 棠
饓	食 棠
丞	氶 一
成	戊 乛
朾	木 丁
呈	口 王
承	氶 三
枨	木 长
诚	言 成	讠 成
郕	成 邑	成 阝
乗	禾 艹 一
城	土 成
娍	女 成
宬	宀 成
峸	山 成
洆	水 丞	氵 丞
荿	草 成	艸 成	艹 成
乘	禾 北
乘	禾 北	禾 丬 匕
埕	土 呈
挰	手 呈	扌 呈	才 呈
晟	日 成
珹	玉 成	王 成
脀	丞 肉	丞 月
掁	手 長	扌 長	才 長
珵	玉 呈	王 呈
碀	石 爭
窚	穴 成
脭	肉 呈	月 呈
铖	金 成	钅 成
堘	土 丷 夫 土	土 𠔉 土
惩	征 心
棖	木 長
椉	亠 舛 木
程	禾 呈
筬	竹 成
絾	絲 成	糹 成	糸 成
裎	衣 呈	衤 呈
塍	肉 丷 夫 土	月 丷 夫 土	肉 𠔉 土
塍	肉 丷 夫 土	月 丷 夫 土	肉 𠔉 土	月 𠔉 土
塖	土 乘
溗	水 乘	氵 乘
誠	言 成	訁 成
畻	田 丷 夫 土	田 𠔉 土
酲	酉 呈
鋮	金 成	釒 成
憕	心 登	忄 登
澂	水 山 一 王 攴	氵 彳 山 一 王 攵 徴
澄	水 登	氵 登
橙	木 登
檙	木 鼎
瀓	水 徵	氵 徵
懲	徴 心
騬	馬 乘
侱	人 呈	亻 呈
徎	彳 呈
悜	心 呈	忄 呈
逞	辵 呈	辶 呈
骋	马 甹	马 由 丂
庱	广 夌
睈	目 呈
騁	馬 甹	馬 由 丂
秤	禾 平
吃	口 乞
侙	人 式	亻 式
哧	口 赤
彨	丽 彡
胵	肉 至	月 至
蚩	屮 一 虫	山 一 虫
蚩	屮 一 蟲	屮 一 虫	山 一 虫
鸱	氐 鸟
瓻	希 瓦
眵	目 多
笞	竹 台
粚	米 丿 一 也
喫	口 契
訵	言 四	訁 四
嗤	口 蚩
媸	女 蚩
摛	手 离	扌 离	才 离
痴	病 知	疒 知
絺	絲 希	糹 希	糸 希
噄	口 潔
瞝	目 离
誺	言 來	訁 來
螭	虫 离
螭	蟲 离	虫 离
鴟	氐 鳥
鵄	至 鳥
癡	病 疑	疒 疑
魑	鬼 离
齝	齒 台
攡	手 離	扌 離	才 離
彲	麗 彡
黐	黍 离
弛	弓 也
池	水 也	氵 也
驰	马 也
迟	辵 尺	辶 尺
坻	土 氐
岻	山 氐
茌	草 仕	艸 仕	艹 仕
持	手 寺	扌 寺	才 寺
竾	竹 也
荎	草 至	艸 至	艹 至
歭	止 寺
蚳	虫 氐
蚳	蟲 氐	虫 氐
赿	走 氐
筂	竹 池
貾	貝 氐
趍	走 多
遟	辵 屖	辶 屖
馳	馬 也
箎	竹 虎
墀	土 犀
漦	未 攵 厂 水
踟	足 知
遲	辵 犀	辶 犀
篪	竹 虒
謘	言 屖	訁 屖
尺	尸 乀
叺	口 入
呎	口 尺
肔	肉 也	月 也
侈	人 多	亻 多
卶	多 卩
齿	止 人 凵
垑	土 多
胣	肉 丿 一 也	月 丿 一 也
恥	耳 心
耻	耳 止
蚇	虫 尺
蚇	蟲 尺	虫 尺
袳	衣 多	衤 多
欼	叕 欠
歯	止 米 凵
袲	衣 多
裭	衣 虎	衤 虎
鉹	金 多	釒 多
褫	衣 虒	衤 虒
齒	止 人 人 凵 一 人 人
彳	丿 人	丿 亻
叱	口 匕
斥	斤 丶
杘	尸 木 
灻	土 火
赤	土 丿 亅 八
饬	饣 丿 一 力
抶	手 失	扌 失	才 失
勅	束 力
恜	心 式	忄 式
炽	火 只
勑	來 力
翄	羽 支
翅	支 羽
敕	束 攴	束 攵
烾	炎 土
痓	病 至	疒 至
啻	帝 口
湁	水 拾	氵 拾
飭	食 丿 一 力
傺	人 祭	亻 祭
痸	病 制	疒 制
腟	肉 室	月 室
跮	足 至
鉓	金 丿 一 巾	釒 丿 一 巾	金 布	釒 布
雴	雨 立
憏	心 祭	忄 祭
瘈	病 契	疒 契
翤	口 冊
遫	辵 敕	辶 敕
銐	列 金
慗	敕 心
瘛	病 恝	疒 恝
翨	羽 是
熾	火 戠
懘	滯 心
趩	走 異
饎	食 喜
鶒	勅 鳥
鷘	敕 鳥
充	亠 允
冲	冫 中	冰 中
忡	心 中	忄 中
沖	水 中	氵 中
茺	草 充	艸 充	艹 充
浺	水 忡	氵 忡
珫	玉 充	王 充
翀	羽 中
舂	夫 一 臼
嘃	口 庸
摏	手 舂	扌 舂	才 舂
徸	彳 童
憃	舂 心
憧	心 童	忄 童
衝	行 重	彳 重 亍
罿	网 童	罒 童
艟	舟 童
蹖	足 舂
虫	口 厶
崇	山 宗
崈	宗 山
隀	阜 重	阝 重
褈	衣 重	衤 重
緟	絲 重	糹 重	糸 重
蝩	虫 重
蝩	蟲 重	虫 重
蟲	虫 虫 虫
爞	火 蟲
爞	火 蟲	火 虫 虫 虫
宠	宀 龙
埫	土 尚
寵	宀 龍
铳	金 充	钅 充
揰	手 重	扌 重	才 重
銃	金 充	釒 充
抽	手 由	扌 由	才 由
婤	女 周
搊	手 芻	扌 芻	才 芻
瘳	病 翏	疒 翏
篘	竹 芻
犨	雔 牛	隹 隹 牛
犫	讎 牛	隹 言 隹 牛
仇	人 九	亻 九
怞	心 由	忄 由
俦	人 寿	亻 寿
帱	巾 寿
栦	木 州
惆	心 周	忄 周
紬	絲 由	糹 由	糸 由
绸	丝 周	纟 周
菗	草 抽	艸 抽	艹 抽
椆	木 周
畴	田 寿
絒	絲 州	糹 州	糸 州
愁	秋 心
皗	白 周
稠	禾 周
筹	竹 寿
裯	衣 周	衤 周
酧	酉 守
酬	酉 州
綢	絲 周	糹 周	糸 周
踌	足 寿
儔	人 壽	亻 壽
雔	隹 隹
嚋	口 壽
嬦	女 壽
幬	巾 壽
懤	心 壽	忄 壽
薵	草 壽	艸 壽	艹 壽
燽	火 壽
雠	隹 言 隹	雔 言	隹 讠 隹
疇	田 壽
籌	竹 壽
躊	足 壽
醻	酉 壽
讎	隹 言 隹	雔 言	隹 訁 隹
讐	雔 言	隹 隹 言
丑	乛 一 丨 一
丒	刃 一
吜	口 丑
杻	木 丑
杽	木 手
侴	人 一 丑 刀	人 一 丑 刂
偢	人 秋	亻 秋
瞅	目 秋
醜	酉 鬼
矁	目 愁
魗	鬼 壽
臭	自 犬
臰	自 死
遚	辵 叟	辶 叟
殠	歹 臭
出	山 凵	山 山	凵 丨 凵
出	山 山	山 凵	凵 丨 凵
初	衣 刀	衤 刀
摴	手 雩	扌 雩	才 雩
樗	木 雩
貙	豸 區
齣	齒 句
刍	刀 彐
除	阜 余	阝 余
芻	勹 屮 勹 屮	勹 勹 草 草	勹 勹 艸
厨	厂 豆 寸
滁	水 除	氵 除
蒢	草 除	艸 除	艹 除
豠	豕 且
锄	金 助	钅 助
媰	女 芻
耡	耒 助
蒭	草 芻	艸 芻	艹 芻
蜍	虫 余
蜍	蟲 余	虫 余
趎	走 朱
鉏	金 且	釒 且
雏	刍 隹
犓	牛 芻	牜 芻
蕏	草 猪	艸 猪	艹 猪
廚	广 尌	广 士 豆 寸
篨	竹 除
鋤	金 助	釒 助
橱	木 厨
幮	巾 廚
櫉	木 厂 尌
藸	草 豬	艸 豬	艹 豬
躇	足 著
雛	芻 隹
櫥	木 廚
蹰	足 厨
鶵	芻 鳥
躕	足 廚
処	夕 几	夂 几
杵	木 午
础	石 出
椘	林 之
储	人 诸	亻 诸
楮	木 者
楚	林 疋
褚	衣 者	衤 者
濋	水 楚	氵 楚
儲	人 諸	亻 諸
檚	木 楚
礎	石 楚
齭	齒 所
齼	齒 楚
亍	一 丁	二 亅
处	夕 卜	夂 卜
竌	立 几
怵	心 术	忄 术
拀	手 兄	扌 兄	才 兄
绌	丝 出	纟 出
豖	豕 丶
柷	木 兄
欪	出 欠
竐	立 殳
俶	人 叔	亻 叔
敊	尗 攴
畜	玄 田
埱	土 叔
珿	玉 足	王 足
絀	絲 出	糹 出	糸 出
處	虎 夕 几	虍 夂 几
傗	人 畜	亻 畜
琡	玉 叔	王 叔
鄐	畜 邑	畜 阝
搐	手 畜	扌 畜	才 畜
滀	水 畜	氵 畜
蓫	草 逐	艸 逐	艹 逐
触	角 虫
踀	足 足
閦	門 众
儊	人 楚	亻 楚
嘼	口 口 田 一 口
諔	言 叔	訁 叔
憷	心 楚	忄 楚
斶	斤 蜀
歜	蜀 欠
臅	肉 蜀	月 蜀
黜	黑 出
觸	角 蜀
矗	直 直 直
欻	炎 欠
歘	焱 欠
揣	手 耑	扌 耑	才 耑
搋	手 虒	扌 虒	才 虒
膗	肉 崔	月 崔
啜	口 叕
嘬	口 最
膪	肉 啻	月 啻
踹	足 耑
川	丿 丨 丨
氚	气 川
氚	氣 川	气 川
穿	穴 牙
剶	彖 刀	彖 刂
猭	犬 彖	犭 彖
瑏	玉 穿	王 穿
传	人 专	亻 专
舡	舟 工
舩	舟 公
船	舟 八 口
圌	囗 耑
遄	辵 耑	辶 耑
傳	人 專	亻 專
椽	木 彖
暷	日 專
篅	竹 耑
輲	車 耑
舛	夕 匚 丨
荈	草 舛	艸 舛	艹 舛
喘	口 耑	口 山 而
歂	耑 欠
僢	人 舜	亻 舜
踳	足 春
汌	水 川	氵 川
串	口 口 丨	中 口
玔	玉 川	王 川
钏	金 川	钅 川
釧	金 川	釒 川
賗	貝 串
鶨	彖 鳥
刅	刀 八
疮	病 仓	疒 仓
窓	穴 厶 心
窗	穴 囱
牎	片 怱
摐	手 從	扌 從	才 從
牕	片 悤
瘡	病 倉	疒 倉
窻	穴 悤	窗 心
床	广 木
牀	爿 木
噇	口 童
幢	巾 童
闯	门 马
傸	人 爽	亻 爽
摤	手 爽	扌 爽	才 爽
磢	石 爽
闖	門 馬
创	仓 刀	仓 刂
怆	心 仓	忄 仓
刱	井 刅
剏	并 刃
剙	并 刅
凔	冰 倉	冫 倉
創	倉 刀	倉 刂
愴	心 倉	忄 倉
吹	口 欠
炊	火 欠
龡	龠 欠
垂	丿 二 土 丨 丨
倕	人 垂	亻 垂
埀	乖 二	乖 土
陲	阜 垂	阝 垂
捶	手 垂	扌 垂	才 垂
菙	草 垂	艸 垂	艹 垂
搥	手 追	扌 追	才 追
棰	木 垂
椎	木 隹
腄	肉 垂	月 垂
槌	木 追
锤	金 垂	钅 垂
箠	竹 垂
錘	金 垂	釒 垂
鎚	金 追	釒 追
顀	隹 頁
旾	屯 日
杶	木 屯
春	手 乀 日	𡗗 日
萅	草 旾	艸 旾	艹 旾
堾	土 春
媋	女 春
暙	日 春
椿	木 春
槆	木 荀
瑃	王 春
箺	竹 春
蝽	虫 春
蝽	蟲 春	虫 春
橁	木 筍
輴	車 盾
櫄	木 熏
鰆	魚 春
鶞	盾 鳥
纯	丝 屯	纟 屯
陙	阜 辰	阝 辰
唇	辰 口
唇	口 辰
浱	水 辰	氵 辰
純	絲 屯	糹 屯	糸 屯
莼	草 纯	艸 纯	艹 纯
淳	水 享	氵 享
脣	辰 肉	辰 月
湻	水 亯	氵 亯
犉	牛 享	牜 享
滣	水 唇	氵 唇
蒓	草 純	艸 純	艹 純
鹑	享 鸟
漘	水 脣	氵 脣
蓴	草 專	艸 專	艹 專
醇	酉 享
醕	酉 亯
錞	金 享	釒 享
鯙	魚 享
鶉	享 鳥
偆	人 春	亻 春
萶	草 春	艸 春	艹 春
惷	春 心
睶	目 春
賰	貝 春
蠢	春 虫 虫
蠢	春 蟲 蟲	春 虫 虫
逴	辵 卓	辶 卓
踔	足 卓
戳	翟 戈	羽 隹 戈
辵	彡 丨 一 人
娕	女 束
娖	女 足
婼	女 若
惙	心 叕	忄 叕
涰	水 叕	氵 叕
绰	丝 卓	纟 卓
腏	肉 叕	月 叕
辍	车 叕
酫	酉 全
綽	絲 卓	糹 卓	糸 卓
趠	走 卓
輟	車 叕
龊	齿 足
擉	手 蜀	扌 蜀	才 蜀
磭	石 脣
繛	素 卓
歠	叕 酉 欠
嚽	口 贅
齪	齒 足
鑡	金 齒	釒 齒
呲	口 此
疵	病 此	疒 此
趀	走 丿 乛 丨 丿
趀	走 丿 乛 丨 丿	走 𠂔
偨	人 柴	亻 柴
偨	人 奓	亻 奓
跐	足 此
縒	絲 差	糹 差	糸 差
骴	骨 此
髊	骨 差
蠀	蟲 資	虫 資
齹	差 齒
词	言 司	讠 司
珁	玉 瓦	王 瓦
垐	次 土
柌	木 司
祠	示 司	礻 司
茈	草 此	艸 此	艹 此
茨	草 次	艸 次	艹 次
堲	即 土
瓷	次 瓦
詞	言 司	訁 司
辝	台 辛
慈	茲 心
甆	兹 瓦
甆	茲 瓦
辞	舌 辛
磁	石 茲	石 兹
雌	此 隹
鹚	兹 鸟
糍	米 兹
糍	米 茲
辤	受 辛
飺	此 食
餈	次 食
嬨	女 慈
濨	水 慈	氵 慈
薋	草 資	艸 資	艹 資
鴜	此 鳥
礠	石 慈
辭	爪 龴 冂 厶 又 辛	爫 龴 冂 厶 又 辛
鶿	兹 鳥
鷀	兹 鳥
此	止 匕
佌	人 此	亻 此
泚	水 此	氵 此
玼	玉 此	王 此
皉	白 此
鮆	此 魚
朿	木 冂
次	冫 欠	冰 欠
伺	人 司	亻 司
佽	人 次	亻 次
刺	朿 刀	朿 刂	木 冂 刀	木 冂 刂
刾	夹 刀	夹 刂
庛	广 此
茦	草 朿	艸 朿	艹 朿
栨	木 次
莿	草 刺	艸 刺	艹 刺
絘	絲 次	糹 次	糸 次
蛓	十 戈 虫	土 戈 虫	𢦏 虫
蛓	十 戈 蟲	土 戈 蟲	十 戈 虫	土 戈 虫	𢦏 蟲	𢦏 虫
赐	贝 易
螆	虫 兹
螆	蟲 茲	虫 茲
賜	貝 易
匆	勿 丶
囪	丶 囗 丿 丿 丶
囱	丶 囗 夕
苁	草 从	艸 从	艹 从
忩	公 心
枞	木 从
怱	匆 心
悤	囱 心
棇	木 忩	木 公 心
焧	火 忩
葱	草 怱	艸 怱	艹 怱
漗	水 悤	氵 悤
聡	耳 忩
蓯	草 從	艸 從	艹 從
蔥	草 悤	艸 悤	艹 悤
骢	马 悤
暰	日 從
樅	木 從
樬	木 悤
熜	火 悤
瑽	玉 從	王 從
璁	玉 悤	王 悤
緫	絲 怱	糹 怱	糸 怱
聦	耳 葱
聪	耳 总
瞛	目 從
篵	竹 從
聰	耳 悤	耳 囱 心
蟌	虫 悤
蟌	蟲 悤	虫 悤
鍯	金 怱	釒 怱
繱	絲 葱	糹 葱	糸 葱
鏦	金 從	釒 從
騘	馬 怱
驄	馬 悤
从	人 人
丛	从 一
従	彳 丷 一 卜 人	彳 丷 下 人 
婃	女 宗
孮	子 宗
徖	彳 宗
從	彳 人 人 疋
悰	心 宗	忄 宗
淙	水 宗	氵 宗
琮	玉 宗	王 宗
慒	心 曹	忄 曹
漎	水 從	氵 從
潀	水 眾	氵 眾
潨	水 衆	氵 衆
誴	言 宗	訁 宗
賨	宗 貝
賩	貝 宗
樷	林 取
藂	草 聚	艸 聚	艹 聚
叢	丵 取	业 丷 二 丨 取	业 羊 取
灇	水 叢	氵 叢
欉	木 叢
爜	火 叢
憁	心 悤	忄 悤
謥	言 悤	訁 悤
凑	冰 奏	冫 奏
湊	水 奏	氵 奏
腠	肉 奏	月 奏
辏	车 奏
輳	車 奏
粗	米 且
觕	牛 角	牜 角
麁	刀 鹿
麄	分 鹿
麤	鹿 鹿 鹿
徂	彳 且
殂	歹 且
促	人 足	亻 足
猝	犬 卒	犭 卒
脨	肉 束	月 束
媨	女 酋
酢	酉 乍
瘄	病 昔	疒 昔
蔟	草 族	艸 族	艹 族
誎	言 束	訁 束
趗	走 足
噈	口 就
憱	心 就	忄 就
踧	足 叔
醋	酉 昔
瘯	病 族	疒 族
簇	竹 族
縬	絲 戚	糹 戚	糸 戚
蹙	戚 足
鼀	圥 黽
蹴	足 就
蹵	就 足
顣	戚 頁
汆	入 水
撺	手 窜	扌 窜	才 窜
鋑	金 夋	釒 夋
镩	金 窜	钅 窜
蹿	足 窜
攛	手 竄	扌 竄	才 竄
躥	足 竄
鑹	金 竄	釒 竄
櫕	木 贊
巑	山 贊
欑	木 贊
穳	禾 贊
窜	穴 串
殩	歹 粲
熶	火 最
篡	竹 目 大 厶
簒	竹 目 大 么
竄	穴 鼠
爨	臼 同 冖 林 大 火
崔	山 隹
催	人 崔	亻 崔
凗	冰 崔	冫 崔
缞	丝 衰	纟 衰
墔	土 崔
嶉	山 唯
慛	心 崔	忄 崔
摧	手 崔	扌 崔	才 崔
榱	木 衰
獕	犬 崔	犭 崔
槯	木 崔
磪	石 崔
縗	絲 衰	糹 衰	糸 衰
鏙	金 崔	釒 崔
漼	水 崔	氵 崔
璀	玉 崔	王 崔
趡	走 崔
皠	白 崔
伜	人 卆	亻 卆
忰	心 卆	忄 卆
疩	病 卆	疒 卆
倅	人 卒	亻 卒
粋	米 卆
紣	絲 卆	糹 卆	糸 卆
翆	羽 卆
脃	肉 色	月 色
脆	肉 危	月 危
啐	口 卒
啛	口 妻
悴	心 卒	忄 卒
淬	水 卒	氵 卒
萃	草 卒	艸 卒	艹 卒
毳	毛 毛 毛
焠	火 卒
脺	肉 卒	月 卒
瘁	病 卒	疒 卒
粹	米 卒
綷	絲 卒	糹 卒	糸 卒
翠	羽 卒
膵	肉 萃	月 萃
膬	肉 毳	月 毳
濢	水 翠	氵 翠
竁	穴 毳
襊	衣 最	衤 最
顇	卒 頁
臎	肉 翠	月 翠
邨	屯 邑	屯 阝
村	木 寸
皴	夋 皮
踆	足 夋
澊	水 尊	氵 尊
竴	立 尊
膥	末 成
存	一 人 子	一 亻 子
侟	人 存	亻 存
拵	手 存	扌 存	才 存
刌	寸 刀	寸 刂
忖	心 寸	忄 寸
寸	一 亅 丶
吋	口 寸
籿	米 寸
搓	手 差	扌 差	才 差
瑳	玉 差	王 差
遳	辵 莝	辶 莝
磋	石 差
撮	手 最	扌 最	才 最
蹉	足 差
醝	酉 差
虘	虎 且	虍 且
嵯	山 差
嵳	山 差
痤	病 坐	疒 坐
睉	目 坐
矬	矢 坐
蒫	草 差	艸 差	艹 差
蔖	草 虘	艸 虘	艹 虘
鹾	卤 差
酂	赞 邑	赞 阝
鹺	鹵 差
躦	足 贊
脞	肉 坐	月 坐
剉	坐 刀	坐 刂
剒	昔 刀	昔 刂
厝	厂 昔
夎	坐 夂
挫	手 坐	扌 坐	才 坐
莝	草 坐	艸 坐	艹 坐
莡	草 足	艸 足	艹 足
措	手 昔	扌 昔	才 昔
逪	辵 昔	辶 昔
斮	昔 斤
棤	木 昔
锉	金 坐	钅 坐
蓌	草 夎	艸 夎	艹 夎	莝 夊
错	金 昔	钅 昔
銼	金 坐	釒 坐
錯	金 昔	釒 昔
咑	口 打
耷	大 耳
荅	草 合	艸 合	艹 合
笚	竹 甲
嗒	口 荅
搭	手 荅	扌 荅	才 荅
褡	衣 荅	衤 荅
噠	口 達
撘	手 答	扌 答	才 答
鎝	金 荅	釒 荅
达	辵 大	辶 大
迏	辵 太	辶 太
迖	辵 犬	辶 犬	达 丶
呾	口 旦
妲	女 旦
怛	心 旦	忄 旦
沓	水 日	氵 日
哒	口 达
炟	火 旦
羍	大 羊
荙	草 达	艸 达	艹 达
畗	亠 口 田	丶 畐 田
剳	荅 刀	荅 刂
匒	勹 荅
畣	人 畐
笪	竹 旦
答	竹 合
詚	言 旦	訁 旦
達	辵 土 羊	辶 土 羊	辵 幸	辶 幸
跶	足 达
阘	门 日 羽
靼	革 旦
薘	草 達	艸 達	艹 達
鞑	革 达
蟽	蟲 達	虫 達
鎉	金 日 羽	釒 日 羽
躂	足 達
鐽	金 達	釒 達
韃	革 達
龖	龍 龍
龘	龍 龍 龍
打	手 丁	扌 丁	才 丁
大	人 一
亣	丶 丌
汏	水 大	氵 大
眔	目 丨 八 八
垯	土 达
瘩	病 荅	疒 荅
墶	土 達
繨	絲 達	糹 達	糸 達
呆	口 木
呔	口 太
獃	豈 犬
懛	心 臺	忄 臺
歹	一 夕
逮	辵 隶	辶 隶
傣	人 泰	亻 泰
代	人 弋	亻 弋
轪	车 大
侢	人 再	亻 再
垈	代 土
岱	代 山
帒	代 巾
甙	甘 弋
绐	丝 台	纟 台
迨	辵 台	辶 台
骀	马 台
带	卅 冖 巾
待	彳 寺
怠	台 心
柋	代 木
殆	歹 台
玳	玉 代	王 代
贷	代 贝
帯	丗 冖 巾
軑	車 大
埭	土 隶
帶	廿 丿 乚 冖 巾
紿	絲 台	糹 台	糸 台
蚮	虫 代
蚮	蟲 代	虫 代
袋	代 衣
軚	車 太
貸	代 貝
軩	車 台
瑇	玉 毒	王 毒
廗	广 帶
叇	云 逮
曃	日 逮
緿	絲 怠	糹 怠	糸 怠
鴏	鳥 代
戴	十 戈 異	土 戈 異	𢦏 異
艜	舟 帶
黛	代 黑
簤	竹 買
蹛	足 帶
瀻	水 戴	氵 戴
霴	雲 隶
襶	衣 戴	衤 戴
黱	肉 丷 夫 黑	月 丷 夫 黑	肉 𠔉 黑	月 𠔉 黑
靆	雲 逮
丹	冂 丶 一
妉	女 冘
单	丷 甲 一
担	手 旦	扌 旦	才 旦
単	小 甲 一	小 日 十	小 曰 十
眈	目 冘
砃	石 丹
耼	耳 冄
耽	耳 冘
郸	单 邑	单 阝
聃	耳 冉
躭	身 冘
單	口 口 甲 一
媅	女 甚
殚	歹 单
瘅	病 单	疒 单
匰	匚 單
箪	竹 単
鄲	單 邑	單 阝
頕	占 頁
儋	人 詹	亻 詹
勯	亶 力
擔	手 詹	扌 詹	才 詹
殫	歹 單
甔	詹 瓦
癉	病 單	疒 單
襌	衣 單	衤 單
簞	竹 單
聸	耳 詹
伔	人 冗	亻 冗
刐	丹 刀	丹 刂
抌	手 冘	扌 冘	才 冘
玬	玉 丹	王 丹
瓭	冘 瓦
胆	肉 旦	月 旦
衴	衣 冘	衤 冘
疸	病 旦	疒 旦
紞	絲 冘	糹 冘	糸 冘
掸	手 单	扌 单
赕	贝 炎
亶	亠 回 旦
撢	手 覃	扌 覃	才 覃
撣	手 單	扌 單	才 單
澸	水 感	氵 感
黕	黑 冘
膽	肉 詹	月 詹
黮	黑 甚
旦	日 一
但	人 旦	亻 旦
帎	巾 冘
沊	冘 水
狚	犬 旦	犭 旦
诞	言 延	讠 延
柦	木 旦
疍	疋 旦
啖	口 炎
啗	口 陷
弹	弓 单
惮	心 单	忄 单
淡	水 炎	氵 炎
萏	草 臽	艸 臽	艹 臽
蛋	疋 虫
蛋	疋 蟲	疋 虫
啿	口 甚
弾	弓 単
氮	气 炎
氮	氣 炎	气 炎
腅	肉 炎	月 炎
蜑	延 虫
蜑	延 蟲	延 虫
觛	角 旦
窞	穴 臽
誕	言 延	訁 延
僤	人 單	亻 單
噉	口 敢
馾	馬 冘
髧	髟 冘
嘾	口 覃
彈	弓 單
憚	心 單	忄 單
憺	心 詹	忄 詹
澹	水 詹	氵 詹
禫	示 覃	礻 覃
駳	馬 延
鴠	旦 鳥
癚	病 詹	疒 詹
嚪	口 閻
繵	絲 亶	糹 亶	糸 亶
贉	貝 覃
霮	雨 湛
饏	敢 食
当	小 彐
珰	玉 当	王 当
裆	衣 当	衤 当
铛	金 当	钅 当
筜	竹 当
當	尚 田
噹	口 當
澢	水 當	氵 當
璫	玉 當	王 當
襠	衣 當	衤 當
簹	竹 當
艡	舟 當
蟷	蟲 當	虫 當
鐺	金 當	釒 當
挡	手 当	扌 当	才 当
党	尚 儿	小 冖 兄
谠	言 党	讠 党
擋	手 當	扌 當	才 當
譡	言 當	訁 當
黨	尚 黑
攩	手 黨	扌 黨	才 黨
灙	水 黨	氵 黨
欓	木 黨
讜	言 黨	訁 黨
氹	乙 水
凼	凵 水
圵	土 上
宕	宀 石
砀	石 弓 丿 丿
垱	土 当
荡	草 汤	艸 汤	艹 汤
档	木 当
菪	草 宕	艸 宕	艹 宕
婸	女 昜
愓	心 昜	忄 昜
瓽	尚 瓦
逿	辵 昜	辶 昜
嵣	山 唐
雼	雨 石
潒	水 象	氵 象
碭	石 昜
儅	人 當	亻 當
瞊	目 唐
蕩	草 湯	艸 湯	艹 湯
趤	走 宕
壋	土 當
檔	木 當
璗	湯 玉
盪	湯 皿
礑	石 當
簜	竹 湯
蘯	草 盪	艸 盪	艹 盪	蕩 皿
闣	門 當
刀	乛 丿
刂	丨 亅
叨	口 刀
忉	心 刀	忄 刀
朷	木 刀
氘	气 丿 丨
氘	氣 丿 丨	气 丿 丨
舠	舟 刀
釖	金 刀	釒 刀
鱽	鱼 刀
魛	魚 刀
捯	手 到	扌 到	才 到
导	巳 寸
岛	勹 丶 勹 山
島	丶 彐 一 勹 山
捣	手 岛	扌 岛	才 岛
祷	示 寿	礻 寿
禂	示 周	礻 周
搗	手 島	扌 島	才 島
隝	阜 島	阝 島
嶋	山 島
嶌	山 島
導	道 寸
隯	阜 壽	阝 壽
壔	土 壽
嶹	山 壽
擣	手 壽	扌 壽	才 壽
蹈	足 舀
禱	示 壽	礻 壽
到	至 刀	至 刂
倒	人 到	亻 到
悼	心 卓	忄 卓
焘	寿 火	寿 灬
盗	次 皿
菿	草 到	艸 到	艹 到
盜	水 欠 皿	氵 欠 皿
道	辵 首	辶 首
稲	禾 爪 旧	禾 爫 旧
箌	竹 到
翢	周 羽
噵	道 口
稻	禾 舀
衜	行 首	彳 首 亍
檤	木 道
衟	行 巛 首	彳 巛 首 亍
燾	壽 火	壽 灬
翿	壽 羽
軇	身 壽
瓙	玉 壽	王 壽
纛	毒 縣
嘚	口 得
恴	亠 日 心
得	彳 日 一 寸
得	彳 日 一 寸	彳 㝵
淂	水 日 一 寸	氵 日 一 寸	水 㝵	氵 㝵
悳	直 心
惪	直 心
棏	木 日 一 寸
棏	木 日 一 寸	木 㝵
锝	金 日 一 寸	钅 日 一 寸	金 㝵	钅 㝵
徳	彳 十 目 心	彳 十 网 心	彳 十 罒 心
德	彳 十 网 一 心	彳 十 罒 一 心
鍀	金 日 一 寸	釒 日 一 寸	金 㝵	釒 㝵
地	土 也
的	白 勺
脦	肉 忒	月 忒
扥	手 丿 一 乚	扌 丿 一 乚	才 丿 一 乚
扽	手 屯	扌 屯	才 屯
灯	火 丁
登	癶 豆
豋	夗 豆
噔	口 登
嬁	女 登
燈	火 登
璒	玉 登	王 登
竳	立 登
簦	竹 登
覴	登 見
蹬	足 登
朩	一 小
等	竹 寺
戥	星 戈
邓	又 邑	又 阝
凳	登 几
鄧	登 邑	登 阝
隥	阜 登	阝 登
墱	土 登
嶝	山 登
瞪	目 登
磴	石 登
镫	金 登	钅 登
櫈	木 凳
鐙	金 登	釒 登
氐	氏 丶
仾	人 互	亻 互
低	人 氐	亻 氐
奃	大 氐
彽	彳 氐
袛	衣 氐	衤 氐
啲	口 的
埞	土 定
羝	羊 氐
隄	阜 是	阝 是
堤	土 是
趆	走 氐
滴	水 啇	氵 啇
镝	金 啇	钅 啇
磾	石 單
鍉	金 是	釒 是
鞮	革 是
廸	廴 由
狄	犬 火	犭 火
籴	入 米
苖	草 由	艸 由	艹 由
迪	辵 由	辶 由
唙	口 狄
敌	舌 攴	舌 攵
涤	水 条	氵 条
荻	草 狄	艸 狄	艹 狄
梑	木 狄
笛	竹 由
觌	卖 见
靮	革 勺
滌	水 條	氵 條
馰	馬 勺
髢	髟 也
嘀	口 啇
嫡	女 啇
翟	羽 隹
蔋	草 淑	艸 淑	艹 淑
蔐	草 啇	艸 啇	艹 啇
頔	由 頁
敵	啇 攴	啇 攵
樀	木 啇
篴	竹 逐
嚁	口 翟
藡	草 適	艸 適	艹 適
豴	豕 啇
蹢	足 啇
鬄	髟 易
鏑	金 啇	釒 啇
糴	籴 翟
覿	賣 見
鸐	翟 鳥
厎	厂 氐
坘	土 互
诋	言 氐	讠 氐	言 氏 丶
邸	氐 邑	氐 阝	氏 丶 邑
阺	阜 氐	阝 氐
呧	口 氐
底	广 氐
弤	弓 氐
抵	手 氐	扌 氐	才 氐	手 氏 丶
拞	手 丘	扌 丘	才 丘
柢	木 氐
牴	牛 氐	牜 氐
砥	石 氐
掋	手 底	扌 底	才 底
菧	草 底	艸 底	艹 底
觝	角 氐
詆	言 氐	訁 氐	言 氏 丶
軧	車 氐
聜	耳 空
骶	骨 氐
坔	土 水
弟	丷 弔 丿	丷 弓 丨 丿
旳	日 勺
杕	木 大
玓	玉 勺	王 勺
怟	心 氐	忄 氐
俤	人 弟	亻 弟
帝	亠 丷 冖 巾
埊	山 水 土
娣	女 弟
递	辵 弟	辶 弟
逓	辵 乕	辶 乕
偙	人 帝	亻 帝
啇	亠 丷 冂 古
梊	折 木
焍	火 弟
珶	玉 弟	王 弟
眱	目 夷
祶	示 弟	礻 弟
第	竹 弔 丿	竹 弓 丨 丿
菂	草 的	艸 的	艹 的
谛	言 帝	讠 帝
釱	金 大	釒 大
媂	女 帝
棣	木 隶
渧	水 帝	氵 帝
睇	目 弟
缔	丝 帝	纟 帝
蒂	草 帝	艸 帝	艹 帝
僀	人 帶	亻 帶
禘	示 帝	礻 帝
腣	肉 帝	月 帝
遞	辵 厂 虎	辶 厂 虎
鉪	金 世	釒 世
墑	土 啇
墬	阜 彖 土	阝 彖 土
摕	手 帶	扌 帶	才 帶
碲	石 帝
蔕	草 帶	艸 帶	艹 帶
蝃	虫 叕
蝃	蟲 叕	虫 叕
遰	辵 帶	辶 帶
慸	帶 心
甋	啇 瓦
締	絲 帝	糹 帝	糸 帝
嶳	山 豕 土 土
諦	言 帝	訁 帝
踶	足 是
螮	蟲 帶	虫 帶
甸	勹 田
敁	占 攴
掂	手 店	扌 店	才 店
傎	人 真	亻 真
厧	厂 真
嵮	山 真
滇	水 真	氵 真
槇	木 真
槙	木 真
瘨	病 真	疒 真
颠	真 页
蹎	足 真
巅	山 顛
顚	眞 頁
顛	真 頁
癫	病 颠	疒 颠
巓	山 顚
巔	山 顛
攧	手 顛	扌 顛	才 顛
癲	病 顛	疒 顛
齻	齒 真
典	曲 八
奌	占 大
点	占 火	占 灬
婰	女 典
敟	典 攴	典 攵
跕	足 占
碘	石 典
蒧	草 戊 占	艸 戊 占	艹 戊 占
蕇	草 單	艸 單	艹 單
踮	足 店
點	黑 占
嚸	口 點
电	日 乚
佃	人 田	亻 田
阽	阜 占	阝 占
坫	土 占
店	广 占
垫	执 土
扂	戶 占
扂	户 占
玷	玉 占	王 占
钿	金 田	钅 田
婝	女 定
惦	心 店	忄 店
淀	水 定	氵 定
奠	酋 大
琔	玉 定	王 定
殿	尸 共 殳
蜔	虫 甸
蜔	蟲 甸	虫 甸
電	雨 电
墊	執 土
壂	殿 土
橂	木 奠
橝	木 覃
澱	水 殿	氵 殿
靛	青 定
癜	病 殿	疒 殿
簟	竹 覃
驔	馬 覃
刁	乛 一
叼	口 刁
汈	水 刁	氵 刁
刟	召 刀	召 刂
虭	虫 刀
虭	蟲 刀	虫 刀
凋	冰 周	冫 周
奝	大 周
弴	弓 享
彫	周 彡
蛁	虫 召
蛁	蟲 召	虫 召
琱	玉 周	王 周
貂	豸 召
碉	石 周
鳭	刀 鳥
殦	歹 鳥
瞗	目 鳥
雕	周 隹
鮉	魚 召
鲷	鱼 周
鼦	鼠 召
鯛	魚 周
鵰	周 鳥
扚	手 勺	扌 勺	才 勺
屌	尸 吊
弔	弓 丨
伄	人 弔	亻 弔
吊	口 巾
钓	金 勺	钅 勺
窎	穴 鸟
訋	言 勺	訁 勺
调	言 周	讠 周
掉	手 卓	扌 卓	才 卓
釣	金 勺	釒 勺
铞	金 吊	钅 吊
铫	金 兆	钅 兆
鈟	金 弔	釒 弔
竨	立 卓
蓧	草 條	艸 條	艹 條
銱	金 吊	釒 吊
雿	雨 兆
魡	魚 勺
調	言 周	訁 周
瘹	病 釣	疒 釣
窵	穴 鳥
鋽	金 卓	釒 卓
藋	草 翟	艸 翟	艹 翟
鑃	金 翟	釒 翟
爹	父 多
跌	足 失
嗲	口 爹
褺	執 衣
苵	草 失	艸 失	艹 失
迭	辵 失	辶 失
垤	土 至
峌	山 至
恎	心 至	忄 至
挕	手 耳	扌 耳	才 耳
昳	日 失
绖	丝 至	纟 至
胅	肉 失	月 失
瓞	瓜 失
眣	目 失
耊	老 至	耂 至
戜	戈 呈
谍	言 枼	讠 枼	言 世 木
喋	口 枼	口 世 木
堞	土 枼
惵	心 枼	忄 枼
揲	手 枼	扌 枼	才 枼
畳	田 冝
絰	絲 至	糹 至	糸 至
耋	老 至
臷	十 戈 至	土 戈 至	𢦏 至
詄	言 失	訁 失
趃	走 失
镻	镸 失
镻	長 失	镸 失
叠	叒 冝
殜	歹 枼
牃	爿 枼
牒	片 枼
嵽	山 帶
碟	石 枼	石 世 木
蜨	虫 疌
蜨	蟲 疌	虫 疌
褋	衣 枼	衤 枼
艓	舟 枼
蝶	虫 枼
蝶	蟲 枼	虫 枼
諜	言 枼	訁 枼	言 世 木
蹀	足 枼
鲽	鱼 枼
曡	晶 冝
疉	畾 宀 彑
鰈	魚 枼
疊	畾 冝
氎	畾 宀 彑 毛
哋	口 地
眰	目 至
丁	一 亅
仃	人 丁	亻 丁
叮	口 丁
帄	巾 丁
玎	玉 丁	王 丁
疔	病 丁	疒 丁
盯	目 丁
钉	金 丁	钅 丁
耵	耳 丁
虰	虫 丁
虰	蟲 丁	虫 丁
酊	酉 丁
釘	金 丁	釒 丁
靪	革 丁
奵	女 丁
顶	丁 页
頂	丁 頁
鼎	目 爿 片
嵿	山 頂
鼑	卜 鼎
濎	水 鼎	氵 鼎
薡	草 鼎	艸 鼎	艹 鼎
鐤	金 鼎	釒 鼎
订	言 丁	讠 丁
忊	心 丁	忄 丁
饤	饣 丁
矴	石 丁
定	宀 疋
訂	言 丁	訁 丁
飣	食 丁
啶	口 定
萣	艹 冖 疋
铤	金 廷	钅 廷
椗	木 定
腚	肉 定	月 定
碇	石 定
锭	金 定	钅 定
碠	石 亭
鋌	金 廷	釒 廷
錠	金 定	釒 定
磸	石 奠
顁	定 頁
丟	三 厶
丢	丿 去
铥	金 丢	钅 丢
銩	金 丟	釒 丟
东	一 𠃋 小
冬	夕 冰	夂 冫
咚	口 冬
岽	山 东
東	木 日
苳	草 冬	艸 冬	艹 冬
昸	日 冬
氡	气 冬
氡	氣 冬	气 冬
倲	人 東	亻 東
鸫	东 鸟
埬	土 東
娻	女 東
崠	山 東
崬	山 東
涷	水 東	氵 東
笗	竹 冬
菄	草 東	艸 東	艹 東
氭	氣 東	气 東
蝀	蟲 東	虫 東
鼕	鼓 冬
鯟	魚 東
鶇	東 鳥
董	草 重	艸 重	艹 重
墥	土 童
嬞	女 董
懂	心 董	忄 董
箽	竹 重
蕫	草 童	艸 童	艹 童
諌	言 東	訁 東
动	云 力
冻	冰 东	冫 东
侗	人 同	亻 同
垌	土 同
姛	女 同
峒	山 同
恫	心 同	忄 同
挏	手 同	扌 同	才 同
栋	木 东
洞	水 同	氵 同
胨	肉 东	月 东
迵	辵 同	辶 同
凍	冰 東	冫 東
戙	同 戈
胴	肉 同	月 同
動	重 力
硐	石 同
棟	木 東
湩	水 重	氵 重
絧	絲 同	糹 同	糸 同
腖	肉 東	月 東
働	人 動	亻 動
駧	馬 同
霘	雨 洞
吺	口 殳
唗	口 走
都	者 邑	者 阝
兜	匚 白 乛 一 儿
兠	北 白 儿	丬 白 匕 儿
蔸	草 兜	艸 兜	艹 兜
橷	木 兠	木 北 白 几
篼	竹 兜
阧	阜 斗	阝 斗
抖	手 斗	扌 斗	才 斗
枓	木 斗
陡	阜 走	阝 走
唞	口 抖
蚪	虫 斗
蚪	蟲 斗	虫 斗
鈄	金 斗	釒 斗
斗	丶 丶 十
斗	丶 丶 一 丨
豆	一 口 丷 一
郖	豆 邑	豆 阝
浢	水 豆	氵 豆
荳	草 豆	艸 豆	艹 豆
逗	辵 豆	辶 豆
饾	饣 豆
鬥	丨 王 王 亅
梪	木 豆
毭	豆 毛
脰	肉 豆	月 豆
酘	酉 殳
痘	病 豆	疒 豆
閗	門 斗
窦	穴 卖
鬦	鬥 斗
餖	食 豆
斣	蜀 斗
闘	門 豆 寸
竇	穴 賣
鬪	鬥 豆 寸
鬭	鬥 斲
鬬	鬥 斵
厾	乙 去
剢	豖 刀	豖 刂
阇	门 者
嘟	口 都
督	叔 目
醏	酉 者
闍	門 者
毒	丰 毋	丰 母
独	犬 虫	犭 虫
涜	水 売	氵 売
读	言 卖	讠 卖
渎	水 卖	氵 卖
椟	木 卖
牍	片 卖
犊	牛 卖	牜 卖
碡	石 毒
裻	叔 衣
読	言 売	訁 売
蝳	虫 毒
蝳	蟲 毒	虫 毒
獨	犬 蜀	犭 蜀
錖	叔 金
凟	冰 賣	冫 賣
匵	匚 賣
嬻	女 賣
瀆	水 賣	氵 賣
櫝	木 賣
殰	歹 賣
牘	片 賣
犢	牛 賣	牜 賣
瓄	玉 賣	王 賣
皾	賣 皮
騳	馬 馬
黩	黑 卖
讀	言 賣	訁 賣
豄	谷 賣
贕	卵 賣
韣	韋 蜀
髑	骨 蜀
鑟	金 賣	釒 賣
韇	革 賣
韥	韋 賣
黷	黑 賣
讟	言 賣 言
笃	竹 马
堵	土 者
帾	巾 者
琽	玉 者	王 者
赌	贝 者
睹	目 者
覩	者 見
賭	貝 者
篤	竹 馬
芏	草 土	艸 土	艹 土
妒	女 戶	女 户	女 戸
杜	木 土
肚	肉 土	月 土
妬	女 石
度	广 廿 又
荰	草 杜	艸 杜	艹 杜
秺	禾 宅
渡	水 度	氵 度
靯	革 土
镀	金 度	钅 度
螙	木 虫 虫
螙	木 蟲 蟲	木 虫 虫
殬	歹 睪
鍍	金 度	釒 度
蠧	士 冖 石 虫 虫
蠧	士 冖 石 蟲 蟲	士 冖 石 虫 虫
蠹	一 中 冖 石 虫 虫
蠹	一 中 冖 石 蟲 蟲	一 中 冖 石 虫 虫
耑	山 而
偳	人 耑	亻 耑
剬	耑 刀	耑 刂
媏	女 耑
端	立 耑	立 山 而
褍	衣 耑	衤 耑
鍴	金 耑	釒 耑
短	矢 豆
段	丿 丰 殳
断	丨 一 米 斤
塅	土 段
缎	丝 段	纟 段
葮	草 段	艸 段	艹 段
椴	木 段
煅	火 段
瑖	玉 段	王 段
腶	肉 段	月 段
碫	石 段
锻	金 段	钅 段
緞	絲 段	糹 段	糸 段
毈	卵 段
簖	竹 断
鍛	金 段	釒 段
斷	丨 二 幺 幺 幺 幺 斤
躖	足 丨 二 幺 幺 幺 幺
籪	竹 斷
垖	土 戶 乛 一	土 户 乛 一
堆	土 隹
塠	土 追
嵟	山 隹
痽	病 隹	疒 隹
磓	石 追
鴭	戶 乛 一 鳥	户 乛 一 鳥
鐜	享 金
頧	戶 乛 一 頁
队	阜 人	阝 人
对	又 寸
兊	公 儿	八 允
兌	八 兄	八 口 儿
兑	丷 兄	丷 口 儿
対	文 寸
祋	示 殳	礻 殳
怼	对 心
陮	阜 隹	阝 隹
隊	阜 丷 豕	阝 丷 豕
碓	石 隹
綐	絲 兌	糹 兌	糸 兌
對	业 羊 寸
憞	心 敦	忄 敦
憝	敦 心
濧	水 對	氵 對
薱	草 對	艸 對	艹 對
镦	金 敦	钅 敦
懟	對 心
瀩	水 頹	氵 頹
譈	言 敦	訁 敦
鐓	金 敦	釒 敦
譵	言 對	訁 對
吨	口 屯
惇	心 享	忄 享
敦	享 攴	享 攵
蜳	虫 享
蜳	蟲 享	虫 享
墩	土 敦
墪	敦 土
撴	手 敦	扌 敦	才 敦
噸	口 頓
撉	敦 手
橔	木 敦
犜	牛 敦	牜 敦
礅	石 敦
蹲	足 尊
蹾	足 敦
驐	馬 敦
盹	目 屯
趸	万 足
躉	萬 足
伅	人 屯	亻 屯
囤	囗 屯
庉	广 屯
沌	水 屯	氵 屯
炖	火 屯
盾	厂 十 目
砘	石 屯
逇	辵 地	辶 地
钝	金 屯	钅 屯
顿	屯 页
遁	辵 盾	辶 盾
鈍	金 屯	釒 屯
楯	木 盾
頓	屯 頁
遯	辵 豚	辶 豚
潡	水 敦	氵 敦
燉	火 敦
踲	足 盾
多	夕 夕
夛	彐 夕
咄	口 出
哆	口 多
剟	叕 刀	叕 刂
崜	山 垂
掇	手 叕	扌 叕	才 叕
敠	叕 攴
敪	叕 攴	叕 攵
毲	叕 毛
裰	衣 叕	衤 叕
嚉	口 對
夺	大 寸
铎	金 又 二 丨	钅 又 二 丨
剫	度 刀	度 刂
敓	兌 攴	兌 攵
敚	兑 攴	兑 攵
喥	口 度
痥	病 兌	疒 兌
痥	病 兑	疒 兑
鈬	金 尺	釒 尺
奪	大 隹 寸
凙	冰 睪	冫 睪
踱	足 度
鮵	魚 兌
鐸	金 睪	釒 睪
朵	几 木
朶	乃 木
哚	口 朵
垛	土 朵
垜	土 朶
挅	手 朶	扌 朶	才 朶
挆	手 朵	扌 朵
挆	手 朵	扌 朵	才 朵
埵	土 垂
缍	丝 垂	纟 垂
椯	木 耑
趓	走 朵
躱	身 朶
躲	身 朵
綞	絲 垂	糹 垂	糸 垂
亸	享 单
鍺	金 者	釒 者
軃	身 單
嚲	享 單
奲	奢 單
刴	朶 刀	朶 刂
剁	朵 刀	朵 刂
陊	阜 多	阝 多
陏	阜 有	阝 有
饳	饣 出
尮	尢 朶
柁	木 它
柮	木 出
桗	木 朶
堕	陏 土
舵	舟 它
惰	心 左 肉	忄 左 月
跢	足 多
跥	足 朶
跺	足 朵
飿	食 出
墮	隋 土
嶞	隋 山
憜	心 隋	忄 隋
墯	惰 土
鵽	叕 鳥
妸	女 可
妿	加 女
娿	阿 女
婀	女 阿
屙	尸 阿
痾	病 阿	疒 阿
讹	言 化	讠 化
吪	口 化
囮	囗 化
迗	辵 天	辶 天
俄	人 我	亻 我
娥	女 我
峨	山 我
峩	山 我
涐	水 我	氵 我
莪	草 我	艸 我	艹 我
珴	玉 我	王 我
訛	言 化	訁 化
皒	白 我
睋	目 我
鈋	金 化	釒 化
锇	金 我	钅 我
鹅	我 鸟
蛾	虫 我
蛾	蟲 我	虫 我
磀	石 逆
誐	言 我	訁 我
頟	各 頁
额	客 页
魤	魚 化
額	客 頁
鵝	我 鳥
鵞	我 鳥
譌	言 爲	訁 爲	言 為	訁 為
鰪	魚 盍
枙	木 厄
砈	石 厄
頋	厄 頁
噁	口 惡
騀	馬 我
厄	厂 卩	厂 㔾
屵	山 厂
戹	戶 乙
戹	户 乙
歺	丨 歹	卜 夕
岋	山 及
阨	阜 厄	阝 厄
呃	口 厄
扼	手 厄	扌 厄	才 厄
苊	草 厄	艸 厄	艹 厄
阸	阜 戹	阝 戹
呝	口 戹
砐	石 及
轭	车 厄
咢	口 口 亏
咹	口 安
垩	亚 土
姶	女 合
峉	山 各
匎	勹 奄
恶	亚 心
砨	石 戹
蚅	虫 厄
蚅	蟲 厄	虫 厄
饿	食 我	饣 我
偔	人 咢	亻 咢
卾	咢 卩
堊	亞 土
悪	亜 心
硆	石 合
谔	言 咢	讠 咢
軛	車 厄
鄂	咢 邑	咢 阝
阏	门 於
堮	土 咢
崿	山 咢
惡	亞 心
愕	心 咢	忄 咢
湂	水 咢	氵 咢
萼	草 咢	艸 咢	艹 咢
豟	豕 戹
軶	車 戹
遌	辵 咢	辶 咢
遏	辵 曷	辶 曷
鈪	金 厄	釒 厄
廅	广 盍
搤	手 益	扌 益	才 益
搹	手 鬲	扌 鬲	才 鬲
琧	亞 玉
腭	肉 咢	月 咢
詻	言 各	訁 各
僫	人 惡	亻 惡
蝁	亞 蟲	亞 虫
锷	金 咢	钅 咢
魥	魚 及
鹗	咢 鸟
蕚	草 品 亏	艸 品 亏	艹 品 亏	草 口 咢	艸 口 咢	艹 口 咢
遻	辵 口 口 屰	辶 口 口 屰
頞	安 頁
颚	咢 页
餓	食 我	飠 我
噩	王 口 口 口 口	一 口 口 一 口 口 一 丨
覨	咢 見
諤	言 咢	訁 咢
閼	門 於
餩	食 八 亥
鍔	金 咢	釒 咢
鳄	鱼 咢
歞	日 幺 幺 火 欠	日 幺 幺 灬 欠	㬎 欠
顎	咢 頁
礘	石 日 幺 幺 火	石 日 幺 幺 灬	石 㬎
櫮	木 噩
鰐	魚 咢
鶚	咢 鳥
讍	言 噩	訁 噩
齃	鼻 曷
鑩	金 噩	釒 噩
齶	齒 咢
鱷	魚 噩
诶	言 矣	讠 矣
誒	言 矣	訁 矣
奀	不 大
恩	因 心
蒽	草 恩	艸 恩	艹 恩
煾	火 恩
峎	山 艮
摁	手 恩	扌 恩	才 恩
鞥	革 弇
儿	丿 乚
而	一 丶 冂 丨 丨
児	旧 儿
侕	人 而	亻 而
兒	臼 儿
陑	阜 而	阝 而
峏	山 而
洏	水 而	氵 而
荋	草 而	艸 而	艹 而
栭	木 而
胹	肉 而	月 而
唲	口 兒
袻	衣 而	衤 而
鸸	而 鸟
聏	耳 而
輀	車 而
鲕	鱼 而
隭	阜 需	阝 需
髵	髟 而
鮞	魚 而
鴯	而 鳥
轜	車 需
尒	人 小
尓	丿 一 小
尔	刀 小	丿 乛 亅 八
耳	一 丨 丨 三
迩	辶 尔
洱	水 耳	氵 耳
饵	食 耳	饣 耳
栮	木 耳
毦	耳 毛
珥	玉 耳	王 耳
铒	金 耳	钅 耳
爾	一 八 冂 丨 爻 爻
餌	食 耳	飠 耳
駬	馬 耳
薾	草 爾	艸 爾	艹 爾
邇	辵 爾	辶 爾
二	一 一
弍	弋 二
弐	一 弋 二
佴	人 耳	亻 耳
刵	耳 刀	耳 刂
咡	口 耳
贰	弋 二 贝
貮	一 弋 貝
衈	血 耳
貳	弋 二 貝
誀	言 耳	訁 耳
鉺	金 耳	釒 耳
樲	木 貳
发	丿 犮	丿 友 丶	丿 一 丿 又 丶
发	丿 友 丶	丿 一 丿 又 丶
沷	水 犮	氵 犮
発	癶 兀 一	癶 二 儿	癶 开
發	癶 弓 殳
彂	业 矤
醱	酉 發
乏	丿 之
伐	人 戈	亻 戈
姂	女 乏
垡	伐 土
疺	病 乏	疒 乏
罚	网 言 刀	罒 讠 刂	罓 讠 刂
茷	草 伐	艸 伐	艹 伐
阀	门 伐
栰	木 伐
砝	石 去
笩	竹 代
傠	人 討	亻 討
筏	竹 伐
瞂	盾 犮
罰	网 言 刀	罒 訁 刂	罓 訁 刂
閥	門 伐
罸	网 討	罒 討
橃	木 發
藅	草 罰	艸 罰	艹 罰
佱	人 一 正	亻 一 正
法	水 去	氵 去
珐	玉 法 琺	王 法 琺
琺	玉 法	王 法
髪	髟 友
蕟	草 發	艸 發	艹 發
髮	髟 犮
帆	巾 凡
忛	心 凡	忄 凡
番	釆 田	采 田
勫	番 力
噃	口 番
嬏	女 番
幡	巾 番
憣	心 番	忄 番
蕃	草 番	艸 番	艹 番
旙	方 番
旛	方 丿 一 番
繙	絲 番	糹 番	糸 番
翻	番 羽
藩	草 潘	艸 潘	艹 潘
轓	車 番
颿	馬 風
籓	竹 潘
飜	番 飛
鱕	魚 番
凡	几 丶
凢	丶 几
凣	丨 几	丶 几
氾	水 卩	氵 卩	水 㔾	氵 㔾
匥	匚 弁
杋	木 凡
柉	木 乏
矾	石 凡
籵	米 十
钒	金 凡	钅 凡
烦	火 页
舧	舟 凡
笲	竹 弁
棥	木 爻 木	林 爻
渢	水 風	氵 風
煩	火 頁
緐	每 系
墦	土 番
樊	棥 大
樊	棥 大	木 爻 木 大
橎	木 番
燔	火 番
璠	玉 番	王 番
膰	肉 番	月 番
薠	草 煩	艸 煩	艹 煩
繁	每 攴 丝	每 攵 糸
繁	每 攴 絲	每 攵 糸
襎	衣 番	衤 番
羳	羊 番
蹯	足 番
瀪	敏 泉
瀿	水 繁	氵 繁
礬	棥 大 石	木 爻 木 大 石
蘩	草 繁	艸 繁	艹 繁
鐇	金 番	釒 番
蠜	棥 大 虫	木 爻 木 大 虫
蠜	棥 大 蟲	棥 大 虫	木 爻 木 大 蟲	木 爻 木 大 虫
鷭	番 鳥
反	厂 又
払	手 厶	扌 厶	才 厶
仮	人 反	亻 反
返	辵 反	辶 反
釩	金 凡	釒 凡
犯	犬 卩	犭 卩	犬 㔾	犭 㔾
奿	丸 女
汎	水 凡	氵 凡
泛	水 乏	氵 乏
饭	食 反	饣 反
范	草 氾	艸 氾	艹 氾
贩	贝 反
畈	田 反
訉	言 凡	訁 凡
軓	車 凡
婏	女 兔
梵	木 木 凡
盕	汎 皿
笵	竹 氾
販	貝 反
軬	厶 大 車
飯	食 反	飠 反
飰	食 卞
滼	水 梵	氵 梵
嬎	女 免 生
範	竹 車 卩	竹 車 㔾
方	亠 勹	亠 刀
邡	方 邑	方 阝
坊	土 方
汸	水 方	氵 方
芳	草 方	艸 方	艹 方
枋	木 方
牥	牛 方	牜 方
钫	金 方	钅 方
淓	水 芳	氵 芳
蚄	虫 方
蚄	蟲 方	虫 方
鈁	金 方	釒 方
鴋	方 鳥
防	阜 方	阝 方
妨	女 方
房	戶 方	户 方	戸 方
肪	肉 方	月 方
埅	防 土
鲂	鱼 方
魴	魚 方
鰟	魚 旁
仿	人 方	亻 方
访	言 方	讠 方
彷	彳 方
纺	丝 方	纟 方
昉	日 方
昘	日 方
瓬	方 瓦
眆	目 方
倣	人 放	亻 放
旊	方 丿 一 瓦
紡	絲 方	糹 方	糸 方
舫	舟 方
訪	言 方	訁 方
髣	髟 方
鶭	紡 鳥
放	方 攴	方 攵
趽	足 方
飞	乙 丷
妃	女 己
非	三 丿 丨 三
飛	飞 升 飞
啡	口 非
婓	非 女
渄	水 非	氵 非
绯	丝 非	纟 非
菲	草 非	艸 非	艹 非
扉	戶 非
扉	户 非
猆	非 犬
靟	非 毛
裶	衣 非	衤 非
緋	絲 非	糹 非	糸 非
蜚	虫 非
蜚	蟲 非	虫 非
霏	雨 非
鲱	鱼 非
餥	非 食
馡	香 非
肥	肉 巴	月 巴
淝	水 肥	氵 肥
腓	肉 非	月 非
蜰	肥 虫
蜰	肥 蟲	肥 虫
蟦	蟲 賁	虫 賁
朏	月 出
胐	肉 出	月 出
匪	匚 非
诽	言 非	讠 非
奜	非 大
悱	心 非	忄 非
斐	非 文
棐	非 木
榧	木 匪
翡	非 羽
蕜	草 悲	艸 悲	艹 悲	菲 心
誹	言 非	訁 非
篚	竹 匪
吠	口 犬
芾	草 巿	艸 巿	艹 巿
废	广 发
杮	木 巿
沸	水 弗	氵 弗
狒	犬 弗	犭 弗
肺	肉 巿	月 巿
昲	日 弗
胇	肉 弗	月 弗
费	弗 贝
俷	人 肥	亻 肥
剕	非 刀	非 刂
厞	厂 非
疿	病 弗	疒 弗
陫	阜 非	阝 非
屝	尸 非
萉	草 肥	艸 肥	艹 肥
廃	广 発
費	弗 貝
痱	病 非	疒 非
镄	金 费	钅 费
廢	广 發
曊	日 費
癈	病 發	疒 發
鼣	鼠 犬
濷	水 滿
櫠	木 廢
鯡	魚 非
鐨	金 費	釒 費
靅	雲 費
分	八 刀
吩	口 分
帉	巾 分
纷	丝 分	纟 分
芬	草 分	艸 分	艹 分
昐	日 分
氛	气 分
氛	氣 分	气 分
衯	衣 分	衤 分
紛	絲 分	糹 分	糸 分
翂	羽 分
兝	克 分
棻	芬 木
訜	言 分	訁 分
酚	酉 分
鈖	金 分	釒 分
雰	雨 分
朆	曾 勿
餴	食 奔
饙	食 賁
坟	土 文
妢	女 分
岎	山 分
汾	水 分	氵 分
朌	月 分
枌	木 分
炃	分 火
肦	肉 分	月 分
羒	羊 分
蚠	分 虫
蚠	分 蟲	分 虫
蚡	虫 分
蚡	蟲 分	虫 分
梤	木 山 分
棼	林 分
焚	林 火
蒶	草 紛	艸 紛	艹 紛
馚	香 分
隫	阜 賁	阝 賁
墳	土 賁	土 十 十 十 貝	土 十 艹 貝
幩	巾 賁
濆	水 賁	氵 賁
蕡	草 賁	艸 賁	艹 賁
魵	魚 分
橨	木 賁
燌	火 賁
燓	棥 火	木 爻 木 火
豮	豕 贲
鼢	鼠 分
羵	羊 賁
鼖	十 艹 鼓
豶	豕 賁
轒	車 賁
鐼	金 賁	釒 賁
馩	香 賁
黂	麻 賁
粉	米 分
黺	黹 分
份	人 分	亻 分
弅	分 廾
奋	大 田
忿	分 心
秎	禾 分
偾	人 贲	亻 贲
愤	心 贲	忄 贲	心 十 艹 贝
粪	米 共
僨	人 賁	亻 賁
憤	心 賁	忄 賁	心 十 十 十 貝	忄 十 十 十 貝
奮	大 隹 田
膹	肉 賁	月 賁
糞	米 異	米 田 共
鲼	鱼 贲
瀵	水 糞	氵 糞
鱝	魚 賁
丰	丿 二 丨	三 丨
风	几 乂
仹	人 丰	亻 丰
凨	几 云
凬	几 一 日
妦	女 丰
沣	水 丰	氵 丰
沨	水 风	氵 风
凮	几 百
枫	木 风
封	土 土 寸	圭 寸
疯	病 风	疒 风
盽	目 丰
砜	石 风
風	几 一 蟲	几 一 虫
峯	山 夆
峰	山 夆
偑	人 風	亻 風
桻	木 夆
烽	火 夆
崶	山 封
猦	犬 風	犭 風
葑	草 封	艸 封	艹 封
锋	金 夆	钅 夆
楓	木 風
犎	封 牛
蜂	虫 夆
蜂	蟲 夆	虫 夆
瘋	病 風	疒 風
碸	石 風
僼	人 豐	亻 豐
篈	竹 封
鄷	豊 邑	豊 阝
鋒	金 夆	釒 夆
檒	林 風
豐	山 丰 丰 豆
鏠	金 逢	釒 逢
酆	豐 邑	豐 阝
寷	宀 豐
灃	水 豐	氵 豐
蘴	草 豊	艸 豊	艹 豊
蠭	逢 虫 虫
蠭	逢 蟲 蟲	逢 虫 虫
靊	雨 豐
飌	雚 風
麷	麥 豐
冯	冰 马	冫 马
夆	夂 丰
捀	手 夆	扌 夆	才 夆
浲	水 夆	氵 夆
逢	辵 夆	辶 夆
堸	土 風
馮	冰 馬	冫 馬
摓	手 逢	扌 逢	才 逢
漨	水 逢	氵 逢
綘	絲 夆	糹 夆	糸 夆
艂	舟 夆
讽	言 风	讠 风
覂	西 乏	覀 乏
唪	口 奉
諷	言 風	訁 風
凤	几 又
奉	手 乀 一 十	𡗗 一 十
甮	勿 用
俸	人 奉	亻 奉
湗	水 封	氵 封
焨	火 冐
煈	火 風
缝	丝 逢	纟 逢
赗	贝 冒
鳯	几 鳥
鳳	几 一 鳥
鴌	天 鳥
縫	絲 逢	糹 逢	糸 逢
賵	貝 冒
覅	要 勿
仏	人 厶	亻 厶
坲	土 弗
紑	絲 不	糹 不	糸 不
裦	衣 厂 二 矛
缶	丿 二 山
否	不 口
妚	女 不
缹	缶 火	缶 灬
缻	缶 瓦
殕	歹 咅
雬	雨 木
鴀	不 鳥
夫	一 大	二 人
伕	人 夫	亻 夫
邞	夫 邑	夫 阝
呋	口 夫
妋	女 夫
姇	付 女
玞	玉 夫	王 夫
肤	肉 夫	月 夫
怤	付 心
柎	木 付
砆	石 夫
荂	草 夸	艸 夸	艹 夸
衭	衣 夫	衤 夫
垺	土 孚
尃	甫 寸
荴	草 扶	艸 扶	艹 扶
旉	甫 方
紨	絲 付	糹 付	糸 付
趺	足 夫
麸	麦 夫
痡	病 甫	疒 甫
稃	禾 孚
跗	足 付
鈇	金 夫	釒 夫
筟	竹 孚
綒	絲 孚	糹 孚	糸 孚
鄜	鹿 邑	鹿 阝
孵	卵 孚
豧	豕 甫
敷	旉 攴	旉 攵	甫 方 攴
膚	虎 胃	虍 胃
鳺	夫 鳥
麩	麥 夫
糐	米 尃
麬	麥 皮
麱	麥 甫
懯	敷 心
巿	一 巾
弗	弓 丿 丨
伏	人 犬	亻 犬
凫	勹 丶 丨 乛 几
凫	鸟 几
甶	丶 田
佛	人 弗	亻 弗
冹	冰 犮	冫 犮
刜	弗 刀	弗 刂
孚	爪 子	爫 子
扶	手 夫	扌 夫	才 夫
芙	草 夫	艸 夫	艹 夫
芣	草 不	艸 不	艹 不
咈	口 弗
岪	山 弗
彿	彳 弗
怫	心 弗	忄 弗
拂	手 弗	扌 弗	才 弗
服	月 卩 又
枎	木 夫
泭	水 付	氵 付
绂	丝 犮	纟 犮	丝 友 丶	纟 友 丶
绋	丝 弗	纟 弗
苻	草 付	艸 付	艹 付
茀	草 弗	艸 弗	艹 弗
俘	人 孚	亻 孚
垘	土 伏
柫	木 弗
氟	气 弗
氟	氣 弗	气 弗
洑	水 伏	氵 伏
炥	火 弗
玸	玉 包	王 包
畉	田 夫
畐	一 口 田
祓	示 犮	礻 犮
罘	网 不	罒 不
茯	草 伏	艸 伏	艹 伏
郛	孚 邑	孚 阝
韨	韦 犮	韦 友 丶
哹	口 孚
栿	木 伏
浮	水 孚	氵 孚
砩	石 弗
莩	草 孚	艸 孚	艹 孚
蚨	虫 夫
蚨	蟲 夫	虫 夫
匐	勹 畐
桴	木 孚
涪	水 咅	氵 咅
烰	火 孚
琈	玉 孚	王 孚
符	竹 付
笰	竹 弗
紱	絲 犮	糹 犮	糸 犮
紼	絲 弗	糹 弗	糸 弗
翇	羽 犮
艴	弗 色
菔	草 服	艸 服	艹 服
虙	虎 必	虍 必
袱	衣 伏	衤 伏
幅	巾 畐
棴	木 服
絥	絲 伏	糹 伏	糸 伏
罦	网 孚	罒 孚
葍	草 畐	艸 畐	艹 畐
福	示 畐	礻 畐
粰	米 孚
綍	絲 孛	糹 孛	糸 孛
艀	舟 孚
蜉	虫 孚
蜉	蟲 孚	虫 孚
辐	车 畐
鉘	金 弗	釒 弗
鉜	金 付	釒 付
颫	風 夫
鳧	鳥 几
榑	木 尃
稪	禾 复
箙	竹 服
韍	韋 犮
幞	巾 菐
澓	水 復	氵 復
蝠	虫 畐
蝠	蟲 畐	虫 畐
髴	髟 弗
鴔	乏 鳥
諨	言 畐	訁 畐
踾	足 畐
輻	車 畐
鮄	魚 弗
癁	病 復	疒 復
襆	衣 菐	衤 菐
黻	黹 犮
襥	衣 僕	衤 僕
鵩	服 鳥
鶝	畐 鳥
呒	口 无
抚	手 无	扌 无	才 无
甫	一 丶 用
乶	甫 乙
府	广 付
弣	弓 付
拊	手 付	扌 付	才 付
斧	父 斤
俌	人 甫	亻 甫
俛	人 免	亻 免
胕	肉 付	月 付
郙	甫 邑	甫 阝
鳬	户 一 一 乛 几
俯	人 府	亻 府
釜	父 金
釡	八 金
捬	手 府	扌 府	才 府
辅	车 甫
焤	府 火
盙	甫 皿
腑	肉 府	月 府
滏	水 釜	氵 釜
蜅	虫 甫
蜅	蟲 甫	虫 甫
腐	府 肉	广 付 肉
輔	車 甫
嘸	口 無
撨	手 焦	扌 焦	才 焦
撫	手 無	扌 無	才 無
頫	兆 頁
鬴	鬲 甫
簠	竹 盙
黼	黹 甫
父	八 乂
讣	言 卜	讠 卜
付	人 寸	亻 寸
妇	女 彐
负	刀 贝
附	阜 付	阝 付
咐	口 付
坿	土 付
竎	立 廾
阜	户 乛 一 十
驸	马 付
复	丿 一 日 夕	丿 一 日 夂
峊	戶 乛 一 山	户 乛 一 山
祔	示 付	礻 付
訃	言 卜	訁 卜
負	刀 貝
赴	走 卜
蚥	虫 父
蚥	蟲 父	虫 父
袝	衣 付	衤 付
陚	阜 武	阝 武
偩	人 負	亻 負
冨	冖 畐
冨	冖 畐	冖 一 口 田
副	畐 刀	畐 刂
婦	女 彐 冖 巾
蚹	虫 付
蚹	蟲 付	虫 付
傅	人 甫 寸	亻 甫 寸	亻 尃
媍	女 負
富	宀 畐
復	彳 复
秿	禾 甫
萯	草 負	艸 負	艹 負
蛗	戶 乛 一 虫	户 乛 一 虫
蛗	戶 乛 一 蟲	戶 乛 一 虫	户 乛 一 蟲	户 乛 一 虫
詂	言 付	訁 付
赋	贝 武
椱	木 复
缚	丝 尃	纟 尃
腹	肉 复	月 复
鲋	鱼 付
複	衣 复	衤 复
褔	衣 畐	衤 畐
赙	贝 尃
緮	絲 复	糹 复	糸 复
蕧	草 復	艸 復	艹 復
蝜	蟲 負	虫 負
蝮	虫 复
蝮	蟲 复	虫 复
賦	貝 武
駙	馬 付
嬔	女 免 生
縛	絲 尃	糹 尃	糸 尃
輹	車 复
鮒	魚 付
賻	貝 専	貝 尃
鍑	金 复	釒 复
鍢	金 畐	釒 畐
鳆	鱼 复
覆	西 復	覀 復
馥	香 复
鰒	魚 复
旮	九 日
呷	口 甲
嘎	口 戛
嘠	口 百 冖 戈
钆	金 乚	钅 乚
尜	小 大 小
噶	口 葛
錷	金 軋	釒 軋
尕	乃 小
玍	丿 王	午 一
尬	尢 介
魀	鬼 介
侅	人 亥	亻 亥
该	言 亥	讠 亥
郂	亥 邑	亥 阝
陔	阜 亥	阝 亥
垓	土 亥
姟	女 亥
峐	山 亥
荄	草 亥	艸 亥	艹 亥
晐	日 亥
赅	贝 亥
畡	田 亥
祴	示 戒	礻 戒
絯	絲 亥	糹 亥	糸 亥
該	言 亥	訁 亥
豥	豕 亥
賅	貝 亥
賌	亥 貝
忋	心 己	忄 己
改	己 攴	己 攵
絠	絲 有	糹 有	糸 有
丐	下 勹
丐	下 勹	正 丿
乢	山 乙	山 乚
匃	勹 亾
匄	勹 亡
阣	阜 乞	阝 乞
杚	木 乞
钙	金 丐	钅 丐
盖	草 羊 皿	艸 羊 皿	艹 羊 皿
摡	手 既	扌 既	才 既
溉	水 既	氵 既
葢	草 盇	艸 盇	艹 盇
鈣	金 丐	釒 丐
隑	阜 豈	阝 豈
戤	盈 戈
概	木 既
槩	木 既
蓋	草 盍	艸 盍	艹 盍	艹 去 皿
漑	水 旣	氵 旣
槪	木 旣
瓂	玉 蓋	王 蓋
甘	廿 一
忓	心 干	忄 干
芉	草 干	艸 干	艹 干
迀	辵 干	辶 干
攼	干 攴	干 攵
杆	木 干
玕	玉 干	王 干
肝	肉 干	月 干
坩	土 甘
泔	水 甘	氵 甘
矸	石 干
苷	草 甘	艸 甘	艹 甘
乹	十 日 十 乚
柑	木 甘
竿	竹 干
疳	病 甘	疒 甘
酐	酉 干
粓	米 甘
亁	十 日 干 乞
凲	几 兼
尲	尢 兼
尴	尢 监
筸	竹 旱
漧	水 乾	氵 乾
鳱	干 鳥
尶	兀 監
尷	尢 監
魐	鬼 兼
仠	人 干	亻 干
扞	手 干	扌 干	才 干
皯	皮 干
秆	禾 干
衦	衣 干	衤 干
赶	走 干
敢	丅 耳 攴	丅 耳 攵
桿	木 旱
笴	竹 可
稈	禾 旱
感	咸 心
澉	水 敢	氵 敢
趕	走 旱
橄	木 敢
擀	手 幹	扌 幹	才 幹
簳	竹 幹
鰔	魚 咸
鳡	鱼 感
鱤	魚 感
干	一 十
干	一 十	二 丨
旰	日 干
汵	水 今	氵 今
盰	目 干
绀	丝 甘	纟 甘
倝	十 日 十 人
凎	冰 金	冫 金
淦	水 金	氵 金
紺	絲 甘	糹 甘	糸 甘
詌	言 甘	訁 甘
骭	骨 干
幹	十 日 十 人 干
榦	十 日 十 人 木
檊	木 幹
贑	章 貢
赣	立 早 夕 工 贝	立 早 夂 工 贝
贛	立 早 夕 工 貝	立 早 夂 工 貝
冈	冂 乂
罓	冖 乂
冮	冰 工	冫 工
刚	冈 刀	冈 刂
杠	木 工
纲	丝 冈	纟 冈
肛	肉 工	月 工
岡	冂 丷 一 山
牨	牛 亢	牜 亢
疘	病 工	疒 工
矼	石 工
缸	缶 工
钢	金 冈	钅 冈
剛	岡 刀	岡 刂
罡	网 正	罒 正
堈	土 岡
掆	手 岡	扌 岡	才 岡
釭	金 工	釒 工
棡	木 岡
犅	牛 岡	牜 岡
堽	土 罡
綱	絲 岡	糹 岡	糸 岡
罁	缶 岡
鋼	金 岡	釒 岡
鎠	金 罡	釒 罡
岗	山 冈
崗	山 岡
港	水 巷	氵 巷
焵	火 岡
筻	竹 更
槓	木 貢
戅	贑 心
戆	立 早 攴 页 心	立 早 攵 页 心
皋	白 夲	白 大 十	白 本
羔	羊 火	羊 灬
羙	羊 火
高	亠 口 冂 口
皐	白 二 十 二
髙	亠 丨 一 一 丨 冋
髙	亠 丨 一 一 丨 冋	亠 丨 一 一 丨 冂 口
臯	自 丶 丶 十 丶 丶	自 二 十 二
滜	水 皋	氵 皋
槔	木 皋
睾	丶 目 幸	丶 罒 幸
膏	高 肉	高 月
槹	木 皐
橰	木 臯
篙	竹 高
糕	米 羔
餻	食 羔
櫜	一 中 冂 处 呆
鷎	皋 鳥
鼛	鼓 处 口
鷱	臯 鳥
夰	大 丿 丨
杲	日 木
菒	草 杲	艸 杲	艹 杲
稁	亠 口 冂 禾
稁	亠 口 冖 禾
搞	手 高	扌 高	才 高
缟	丝 高	纟 高
暠	日 高
槀	高 木
槁	木 高
稾	高 禾
稿	禾 高
镐	金 高	钅 高
縞	絲 高	糹 高	糸 高
藁	草 槀	艸 槀	艹 槀	蒿 木
檺	木 豪
藳	草 稾	艸 稾	艹 稾	蒿 禾
吿	牛 口
告	牛 口
勂	告 力
诰	言 告	讠 告
郜	告 邑	告 阝
峼	山 告
祮	示 吉	礻 吉
祰	示 告	礻 告
锆	金 告	钅 告
筶	竹 告
禞	示 高	礻 高
誥	言 告	訁 告
鋯	金 告	釒 告
戈	一 𠄌 丿 丶
仡	人 乞	亻 乞
圪	土 乞
犵	犬 乞	犭 乞
纥	丝 乞	纟 乞
戓	戈 口
肐	肉 乞	月 乞
牫	牛 戈	牜 戈
疙	病 乞	疒 乞
咯	口 各
牱	牛 可	牜 可
哥	可 可
胳	肉 各	月 各
袼	衣 各	衤 各
鸽	合 鸟
割	害 刀	害 刂
搁	手 阁	扌 阁	才 阁
滒	水 哥	氵 哥
戨	哥 戈
歌	哥 欠
鴐	加 鳥
鴚	鳥 可
擱	手 閣	扌 閣	才 閣
謌	言 哥	訁 哥
鴿	合 鳥
鎶	金 哥	釒 哥
呄	乃 古
佮	人 合	亻 合
匌	勹 合
挌	手 各	扌 各	才 各
茖	草 各	艸 各	艹 各
阁	门 各
革	廿 口 十
敋	各 攴	各 攵
格	木 各
鬲	一 口 冂 丫 一
愅	心 革	忄 革
臵	至 各
葛	草 曷	艸 曷	艹 曷
蛒	虫 各
蛒	蟲 各	虫 各
裓	衣 戒	衤 戒
隔	阜 鬲	阝 鬲
嗝	口 鬲
塥	土 鬲
滆	水 鬲	氵 鬲
觡	角 各
搿	手 合 手
槅	木 鬲
膈	肉 鬲	月 鬲
閣	門 各
閤	門 合
獦	犬 葛	犭 葛
镉	金 鬲	钅 鬲
鞈	革 合
韐	韋 合
骼	骨 各
諽	言 革	訁 革
輵	車 曷
鮯	魚 合
韚	韋 革
轕	車 葛
鞷	鬲 革
騔	馬 曷
哿	加 可
舸	舟 可
嗰	口 個
个	人 丨
各	夂 口
虼	虫 乞
虼	蟲 乞	虫 乞
個	人 固	亻 固
硌	石 各
铬	金 各	钅 各
箇	竹 固
给	丝 合	纟 合
給	絲 合	糹 合	糸 合
根	木 艮
跟	足 艮
哏	口 艮
艮	乛 一 一 𠄌 一 𠄌
亘	一 旦	二 日
亙	万 丶 丶 一	二 彑 丶
茛	草 艮	艸 艮	艹 艮
揯	手 恆	扌 恆	才 恆
搄	手 恒	扌 恒	才 恒
刯	亘 刀	亘 刂
庚	广 彐 人	广 肀 人
畊	田 井
浭	水 更	氵 更
耕	耒 井
菮	草 庚	艸 庚	艹 庚
絚	絲 亙	糹 亙	糸 亙
赓	庚 贝
鹒	庚 鸟
緪	絲 恆	糹 恆	糸 恆
縆	絲 恒	糹 恒	糸 恒
羮	羔 一 夫
賡	庚 貝
羹	羔 美
鶊	庚 鳥
郠	更 邑	更 阝
哽	口 更
埂	土 更
峺	山 更
挭	手 更	扌 更	才 更
绠	丝 更	纟 更
耿	耳 火
莄	草 更	艸 更	艹 更
梗	木 更
綆	絲 更	糹 更	糸 更
鲠	鱼 更
骾	骨 更
鯁	魚 更
更	一 日 人	一 曰 人	一 田 人	一 申 人
堩	土 恆
暅	日 恒
工	二 丨	一 丨 一
弓	乛 一 乛
公	八 厶
厷	一 丿 厶
功	工 力
攻	工 攴	工 攵
杛	木 弓
供	人 共	亻 共
糼	絲 力	糹 力	糸 力
肱	肉 厷	月 厷
宫	宀 吕	宀 口 口
宮	宀 呂	宀 口 丶 口
恭	共 心	共 小 丶
蚣	虫 公
蚣	蟲 公	虫 公
躬	身 弓
龚	龙 共
匑	勹 躬
塨	土 恭
幊	巾 貢
愩	心 貢	忄 貢
觥	角 光
躳	身 吕
匔	勹 身 吕
碽	石 貢
觵	角 黄
觵	角 黃
龏	龍 廾
龔	龍 共
廾	一 丿 丨
巩	工 凡
汞	工 水
拱	手 共	扌 共	才 共
拲	共 手
栱	木 共
珙	玉 共	王 共
輁	車 共
鞏	巩 革
共	井 八	十 丨 一 八	二 丨 丨 八
贡	工 贝
羾	羽 工
唝	口 贡
貢	工 貝
勾	勹 厶
佝	人 句	亻 句
沟	水 勾	氵 勾
钩	金 勾	钅 勾
袧	衣 句	衤 句
缑	丝 侯	纟 侯
鈎	金 勾	釒 勾
溝	水 冓	氵 冓
鉤	金 句	釒 句
緱	絲 侯	糹 侯	糸 侯
褠	衣 冓	衤 冓
篝	竹 冓
簼	竹 搆
鞲	革 冓
韝	韋 冓
芶	草 勾	艸 勾	艹 勾
岣	山 句
狗	犬 句	犭 句
苟	草 句	艸 句	艹 句
枸	木 句
玽	玉 句	王 句
耇	老 句	耂 句
耉	考 口
笱	竹 句
耈	老 句
蚼	虫 句
蚼	蟲 句	虫 句
豿	豸 句
坸	土 句
构	木 勾
诟	言 后	讠 后
购	贝 勾
垢	土 后
姤	女 后
茩	草 后	艸 后	艹 后
冓	井 再
够	句 多
夠	多 句
訽	言 句	訁 句
媾	女 冓
彀	士 冖 一 弓 殳
搆	手 冓	扌 冓	才 冓
詬	言 后	訁 后
遘	辵 冓	辶 冓
雊	句 隹
構	木 冓
煹	火 冓
觏	冓 见
撀	殸 手	声 殳 手
覯	冓 見
購	貝 冓
估	人 古	亻 古
呱	口 瓜
咕	口 古
姑	女 古
孤	子 瓜
沽	水 古	氵 古
泒	水 瓜	氵 瓜
苽	草 瓜	艸 瓜	艹 瓜
柧	木 瓜
轱	车 古
唂	口 谷
罛	网 瓜	罒 瓜
鸪	古 鸟
笟	竹 瓜
菇	草 姑	艸 姑	艹 姑
菰	草 孤	艸 孤	艹 孤
蛄	虫 古
蛄	蟲 古	虫 古
觚	角 瓜
軱	車 瓜
軲	車 古
辜	古 辛
酤	酉 古
鈲	金 瓜	釒 瓜
箍	竹 手 匝	竹 扌 匝	竹 才 匝
箛	竹 孤
嫴	女 辜
橭	木 辜
鮕	魚 古
鴣	古 鳥
鶻	骨 鳥
古	十 口
扢	手 乞	扌 乞	才 乞
汩	水 日	氵 日
诂	言 古	讠 古
谷	八 人 口
股	肉 殳	月 殳
牯	牛 古	牜 古
骨	冂 冂 冖 月
唃	口 角
罟	网 古	罒 古
羖	羊 殳
钴	金 古	钅 古
啒	口 屈
淈	水 屈	氵 屈
脵	肉 吴	月 吴
蛊	虫 皿
蛌	虫 瓜
蛌	蟲 瓜	虫 瓜
尳	尢 骨
愲	心 骨	忄 骨
蓇	草 骨	艸 骨	艹 骨
詁	言 古	訁 古
馉	饣 骨
鹄	告 鸟
榾	木 骨
毂	士 冖 车 殳
鈷	金 古	釒 古
鼓	十 豆 支
鼔	十 豆 攴
嘏	古 叚
榖	士 冖 一 木 殳
皷	十 豆 皮
鹘	骨 鸟
穀	士 冖 禾 殳
縎	絲 骨	糹 骨	糸 骨
糓	士 冖 一 米 殳
薣	草 鼓	艸 鼓	艹 鼓
濲	水 穀	氵 穀
皼	壹 皮
臌	肉 鼓	月 鼓
轂	士 冖 一 車 殳
餶	食 骨
瀔	氵 士 冖 禾 殳	氵 穀
盬	臣 丿 一 古 皿
瞽	鼓 目
蠱	蟲 皿	虫 皿
固	囗 古
故	古 攴	古 攵
凅	冰 固	冫 固
顾	厄 页
堌	土 固
崓	山 固
崮	山 固
梏	木 告	木 牛 口
牿	牛 告	牜 告
棝	木 固
祻	示 固	礻 固
雇	户 隹
痼	病 固	疒 固
稒	禾 固
锢	金 固	钅 固
僱	人 雇	亻 雇
錮	金 固	釒 固
鲴	鱼 固
鯝	魚 固
顧	雇 頁
瓜	爪 一 丶
刮	舌 刀	舌 刂
胍	肉 瓜	月 瓜
栝	木 舌
鸹	舌 鸟
煱	火 咼
聒	耳 舌
趏	走 舌
劀	矞 刀	矞 刂
緺	絲 咼	糹 咼	糸 咼
踻	足 咼
銽	金 氏 口	釒 氏 口
颳	風 舌
鴰	舌 鳥
騧	馬 咼
叧	口 刀
剐	呙 刀	呙 刂	口 内 刂
剮	咼 刀	咼 刂
寡	宀 直 分
卦	圭 卜
坬	土 瓜
诖	言 圭	讠 圭
挂	手 圭	扌 圭	才 圭
啩	口 卦
掛	手 卦	扌 卦	才 卦
罣	网 圭	罒 圭
絓	絲 圭	糹 圭	糸 圭
罫	网 卦	罒 卦
褂	衣 卦	衤 卦
詿	言 圭	訁 圭
乖	千 北
掴	手 国	扌 国	才 国
摑	手 國	扌 國	才 國
拐	手 口 刀	扌 口 刀	才 口 刀	手 另
拐	手 另	扌 另	才 另
柺	木 口 刀	木 另
箉	竹 拐
夬	乛 大
叏	乛 支
怪	心 圣	忄 圣
恠	心 在	忄 在
关	丷 天
观	又 见
官	宀 㠯
冠	冖 元 寸
覌	又 見
倌	人 官	亻 官
棺	木 官
蒄	草 冠	艸 冠	艹 冠
関	門 关
瘝	病 眔	疒 眔
癏	病 睘	疒 睘
観	丿 二 隹 見
闗	門 絲
鳏	鱼 眔
關	門 幺 幺 丱	門 幺 幺 卯
鰥	魚 眔
觀	雚 見
鱞	魚 睘
莞	草 完	艸 完	艹 完
馆	食 官	饣 官
琯	玉 官	王 官
痯	病 官	疒 官
筦	竹 完
管	竹 官
輨	車 官
舘	人 舌 官
錧	金 官	釒 官
館	食 官	飠 官
鳤	鱼 管
毌	𠃋 乛 十
贯	母 贝
泴	水 皿
悺	心 官	忄 官
惯	心 贯	忄 贯
掼	手 贯	扌 贯	才 贯
涫	水 官	氵 官
貫	母 貝
悹	官 心
祼	示 果	礻 果
慣	心 貫	忄 貫
摜	手 貫	扌 貫	才 貫
潅	水 丿 二 隹	氵 丿 二 隹
遦	辵 貫	辶 貫
樌	木 貫
盥	臼 水 皿
罆	缶 貫
雚	草 口 口 隹	艸 口 口 隹	艹 口 口 隹
躀	足 貫
鏆	金 貫	釒 貫
灌	水 雚	氵 雚
爟	火 雚
瓘	玉 雚	王 雚
矔	目 雚
礶	石 雚
鹳	雚 鸟
罐	缶 雚
鑵	金 雚	釒 雚
鱹	魚 雚
鸛	雚 鳥
光	小 兀
灮	火 儿
侊	人 光	亻 光
炗	廿 火
炛	火 化
咣	口 光
垙	土 光
姯	女 光
洸	水 光	氵 光
茪	草 光	艸 光	艹 光
桄	木 光
烡	火 共
珖	玉 光	王 光
胱	肉 光	月 光
僙	人 黃	亻 黃	人 黄	亻 黄
輄	車 光
銧	金 光	釒 光
黆	黃 冘
广	丶 一 丿
広	广 厶
犷	犬 广	犭 广
廣	广 黃
獷	犬 廣	犭 廣
臩	臦 夰
俇	人 狂	亻 狂
逛	辵 狂	辶 狂
臦	臣 臣
撗	手 黄	扌 黄	才 黄
撗	手 黃	扌 黃	才 黃
归	丨 丿 彐
圭	土 土
妫	女 为
龟	刀 电
规	夫 见
邽	圭 邑	圭 阝
皈	白 反
茥	草 圭	艸 圭	艹 圭
闺	门 圭
珪	玉 圭	王 圭
亀	龟 日	龟 曰	刀 日 电
亀	龟 日	龟 曰	刀 田 电
傀	人 鬼	亻 鬼
硅	石 圭
窐	穴 圭
袿	衣 圭	衤 圭
規	夫 見
媯	女 為
廆	广 鬼
椝	木 规
瑰	玉 鬼	王 鬼
郌	圭 邑
嫢	規 女
摫	手 規	扌 規	才 規
閨	門 圭
鲑	鱼 圭
嬀	女 爲
槻	木 規
槼	木 規
螝	虫 鬼
螝	蟲 鬼	虫 鬼
璝	玉 貴	王 貴
瞡	目 規
膭	肉 貴	月 貴
鮭	魚 圭
龜	刀 匚 丨 乚 彐 彐 囗 乂
巂	山 隹 冏
歸	𠂤 止 帚
鬶	规 鬲
騩	馬 鬼
瓌	玉 褱	王 褱
鬹	規 鬲
宄	宀 九
氿	水 九	氵 九
朹	木 九
轨	车 九 軌
庋	广 支
佹	人 危	亻 危
匦	匚 轨
诡	言 危	讠 危
陒	阜 危	阝 危
垝	土 危
姽	女 危
恑	心 危	忄 危
攱	立 支
癸	癶 天
軌	車 九
鬼	丶 田 儿 厶
庪	广 技
祪	示 危	礻 危
匭	匚 軌
晷	日 咎
湀	水 癸	氵 癸
蛫	虫 危
蛫	蟲 危	虫 危
觤	角 危
詭	言 危	訁 危
厬	厂 晷
簋	竹 艮 皿
蟡	蟲 為	虫 為
攰	支 力
刽	会 刀	会 刂
刿	岁 刀	岁 刂
昋	夭 日
柜	木 巨
炔	火 夬
贵	中 一 贝
桂	木 圭
桧	木 会
猤	犬 癸	犭 癸
筀	竹 圭
貴	中 一 貝
蓕	草 桂	艸 桂	艹 桂
跪	足 危
匱	匚 貴
劊	會 刀	會 刂
劌	歲 刀	歲 刂
嶡	山 厥
撌	手 貴	扌 貴	才 貴
槶	木 國
檜	木 會
瞶	目 貴
禬	示 會	礻 會
簂	竹 國
櫃	木 匱
癐	病 會	疒 會
襘	衣 會	衤 會
鳜	鱼 厥
鞼	革 貴
鱖	魚 厥
鱥	魚 歲
衮	衣 公
惃	心 昆	忄 昆
绲	丝 昆	纟 昆
袞	衣 八 口
辊	车 昆
滚	水 衮	氵 衮
蓘	草 衮	艸 衮	艹 衮
滾	水 袞	氵 袞
緄	絲 昆	糹 昆	糸 昆
蔉	草 袞	艸 袞	艹 袞
磙	石 衮
輥	車 昆
鲧	鱼 系
鮌	魚 玄
鯀	魚 系
棍	木 昆
睔	目 侖
睴	目 軍
璭	玉 運	王 運
謴	言 貫	訁 貫
呙	口 内
咼	冎 口	冂 乛 冂 口
埚	土 呙	土 口 内
郭	享 邑	享 阝
啯	口 国
堝	土 咼
崞	山 享
鈛	金 戈	釒 戈
锅	金 呙	钅 呙	金 口 内
墎	土 郭
瘑	病 咼	疒 咼
嘓	口 國
彉	弓 黃
濄	水 過	氵 過
蝈	虫 国
鍋	金 咼	釒 咼
彍	弓 廣
蟈	蟲 國	虫 國
囯	囗 王
囶	囗 八 土
囻	囗 民
国	囗 玉
圀	囗 儿 方
國	囗 或
帼	巾 国
腘	肉 国	月 国
幗	巾 國
慖	心 國	忄 國
漍	水 國	氵 國
聝	耳 或
蔮	草 國	艸 國	艹 國
膕	肉 國	月 國
虢	寽 虎
馘	首 或
果	日 木
惈	心 果	忄 果
淉	水 果	氵 果
猓	犬 果	犭 果
菓	草 果	艸 果	艹 果
馃	饣 果
椁	木 享
褁	果 衣
槨	木 郭
粿	米 果
綶	絲 果	糹 果	糸 果
蜾	虫 果
蜾	蟲 果	虫 果
裹	衣 果
輠	車 果
錁	金 果	釒 果
餜	食 果
鐹	金 過	釒 過
过	辵 寸	辶 寸
過	辵 咼	辶 咼
哈	口 合
铪	金 合	钅 合
蛤	虫 合
蛤	蟲 合	虫 合
奤	大 面
咍	口 台
咳	口 亥
嗨	口 海
还	辵 不	辶 不
孩	子 亥
頦	亥 頁
骸	骨 亥
還	辵 睘	辶 睘
海	水 每	氵 每
胲	肉 亥	月 亥
烸	火 每
酼	酉 亠 厶 川	酉 巟	酉 㐬
醢	酉 右 皿
亥	亠 𠃋 丿 人
妎	女 介
骇	马 亥
害	宀 丰 口
氦	气 亥
氦	氣 亥	气 亥
嗐	口 害
餀	食 艾
駭	馬 亥
駴	馬 戒
饚	食 蓋
嚡	口 鞋
佄	人 甘	亻 甘
顸	干 页
哻	口 旱
蚶	虫 甘
蚶	蟲 甘	虫 甘
酣	酉 甘
頇	干 頁
嫨	女 革 大
谽	谷 含
憨	敢 心
馠	香 含
歛	僉 欠
鼾	鼻 干
邗	干 邑	干 阝
含	今 口
邯	甘 邑	甘 阝
函	凵 氶
肣	肉 今	月 今
凾	凵 了 口 又	凵 亟
虷	虫 干
虷	蟲 干	虫 干
唅	口 含
圅	龴 囗 丷 干
娢	女 含
浛	水 含	氵 含
崡	山 函
晗	日 含
梒	木 含
涵	水 函	氵 函
焓	火 含
琀	玉 含	王 含
寒	宀 井 大 冰	宀 井 大 冫
嵅	山 咸
韩	十 日 十 韦
甝	虎 甘
筨	竹 含
蜬	虫 函
蜬	蟲 函	虫 函
澏	水 喦	氵 喦
鋡	金 含	釒 含
魽	魚 甘
韓	十 日 十 韋
厈	厂 干
罕	网 干	罓 干	冖 八 干	㓁 干
浫	水 罕	氵 罕
喊	口 咸
蔊	草 焊	艸 焊	艹 焊
阚	门 敢
豃	谷 敢
鬫	鬥 敢
汉	水 又	氵 又
屽	山 干
汗	水 干	氵 干
闬	门 干
旱	日 干
垾	土 旱
悍	心 旱	忄 旱
捍	手 旱	扌 旱	才 旱
涆	水 旰	氵 旰
猂	犬 旱	犭 旱
莟	草 今	艸 今	艹 今
晘	日 旱
焊	火 旱
菡	草 函	艸 函	艹 函
釬	金 干	釒 干
閈	門 干
皔	白 旱
睅	目 旱
傼	人 革 大	亻 革 大
蛿	虫 含
蛿	蟲 含	虫 含
颔	含 页
馯	馬 干
撖	手 敢	扌 敢	才 敢
漢	水 革 大	氵 革 大
蜭	虫 臽
蜭	蟲 臽	虫 臽
暵	日 革 大
熯	火 革 大
銲	金 旱	釒 旱
鋎	金 完	釒 完
憾	心 感	忄 感
撼	手 感	扌 感	才 感
翰	十 日 十 人 羽
螒	十 日 十 人 虫
螒	十 日 十 人 蟲	十 日 十 人 虫
頷	含 頁
顄	函 頁
駻	馬 旱
譀	言 敢	訁 敢
雗	十 日 十 丿 一 隹
瀚	水 翰	氵 翰
蘫	草 濫	艸 濫	艹 濫
鶾	十 日 十 丿 一 鳥
夯	大 力
苀	草 亢	艸 亢	艹 亢
迒	辵 亢	辶 亢
斻	方 亢
杭	木 亢
绗	丝 行	纟 行
珩	玉 行	王 行
笐	竹 亢
航	舟 亢
蚢	虫 亢
蚢	蟲 亢	虫 亢
颃	亢 页
貥	貝 亢
筕	竹 行
絎	絲 行	糹 行	糸 行
頏	亢 頁
魧	魚 亢
沆	水 亢	氵 亢
茠	草 休	艸 休	艹 休
蒿	草 高	艸 高	艹 高
嚆	口 蒿
薅	草 媷	艸 媷	艹 媷
薧	草 亠 口 冂 死	艸 亠 口 冂 死	艹 亠 口 冂 死
薧	草 亠 口 冖 死	艸 亠 口 冖 死	艹 亠 口 冖 死
蚝	虫 毛
蚝	蟲 毛	虫 毛
毫	亠 口 冂 毛
毫	亠 口 冖 毛
椃	木 虎
嗥	口 皋
獆	犬 皋	犭 皋
貉	豸 各
噑	口 皐
獔	犬 皐	犭 皐
豪	亠 口 冖 豕
嘷	口 臯
獋	犬 臯	犭 臯
諕	言 虎	訁 虎
儫	人 豪	亻 豪
嚎	口 豪
壕	土 豪
濠	水 豪	氵 豪
籇	竹 豪
蠔	蟲 豪	虫 豪
譹	言 豪	訁 豪
好	女 子
郝	赤 邑	赤 阝
号	口 丂
昊	日 天
昦	日 夰
秏	禾 毛
哠	口 告
恏	好 心
悎	心 告	忄 告
浩	水 告	氵 告
耗	耒 毛
晧	日 告
淏	水 昊	氵 昊
傐	人 高	亻 高
皓	白 告
鄗	高 邑	高 阝
滈	水 高	氵 高
聕	耳 告
號	号 虎
暤	日 皋
暭	日 皐
澔	水 皓	氵 皓
皜	白 高
皞	白 皋
曍	日 臯
皡	白 皐
薃	草 滈	艸 滈	艹 滈
皥	白 臯
鎬	金 高	釒 高
颢	景 页
灏	水 颢	氵 颢
顥	景 頁
鰝	魚 高
灝	水 顥	氵 顥
诃	言 可	讠 可
呵	口 可
抲	手 可	扌 可	才 可
欱	合 欠
喝	口 曷
訶	言 可	訁 可
嗬	口 荷
蠚	若 虫 虫
蠚	若 蟲 蟲	若 虫 虫
禾	丿 木
合	人 一 口
何	人 可	亻 可
劾	亥 力
咊	口 禾
和	禾 口
姀	女 禾
河	水 可	氵 可
郃	合 邑	合 阝
峆	山 合
曷	日 勹 丨 一 人
柇	木 禾
狢	犬 各	犭 各
盇	太 皿
籺	米 乞
紇	絲 乞	糹 乞	糸 乞
阂	门 亥
饸	食 合	饣 合
哬	口 何
敆	合 攴
核	木 亥
盉	禾 皿
盍	去 皿
荷	草 何	艸 何	艹 何
啝	口 和
涸	水 固	氵 固
渮	水 荷	氵 荷
盒	合 皿
秴	禾 合
菏	草 河	艸 河	艹 河
萂	草 和	艸 和	艹 和
蚵	虫 可
蚵	蟲 可	虫 可
龁	齿 乞
惒	和 心
訸	言 禾	訁 禾
颌	合 页
楁	木 客
毼	曷 毛
澕	水 華	氵 華
詥	言 合	訁 合
貈	豸 舟
輅	車 各
鉌	金 禾	釒 禾
阖	门 盍
鲄	鱼 可
熆	火 盍
鹖	曷 鸟
麧	麥 乞
頜	合 頁
篕	竹 盍
翮	鬲 羽
螛	虫 害
螛	蟲 害	虫 害
魺	魚 可
礉	石 敫
闔	門 盍
鞨	革 曷
齕	齒 乞
覈	西 敫	襾 敫
鶡	曷 鳥
皬	白 霍
鑉	金 蓋	釒 蓋
龢	龠 禾
佫	人 各	亻 各
垎	土 各
贺	加 贝
袔	衣 可	衤 可
寉	宀 隹
焃	火 赤
賀	加 貝
嗃	口 高
煂	火 革
碋	石 岢
熇	火 高
褐	衣 曷	衤 曷
赫	赤 赤
鹤	隺 鸟
翯	羽 高
壑	卜 冖 一 谷 又 土
癋	病 惡	疒 惡
謞	言 高	訁 高
燺	火 槀
爀	火 赫
鶮	高 鳥
鶴	隺 鳥
靎	雨 鵭
鸖	霍 鳥
靏	雨 鶴
黒	里 火	里 灬
黑	口 丷 土 火	口 丷 土 灬
黑	口 丷 土 火	口 丷 土 灬	里 丷 火	里 丷 灬
嘿	口 黑
潶	水 黑	氵 黑
拫	手 艮	扌 艮	才 艮
痕	病 艮	疒 艮
鞎	革 艮
佷	人 艮	亻 艮
很	彳 艮
狠	犬 艮	犭 艮
詪	言 艮	訁 艮
恨	心 艮	忄 艮
亨	亠 口 了
哼	口 享
悙	心 亨	忄 亨
啈	口 幸
脝	肉 亨	月 亨
姮	女 亘
恆	心 亙	忄 亙
恒	心 亘	忄 亘
桁	木 行
烆	火 行
胻	肉 行	月 行
鸻	行 鸟
横	木 黄
橫	木 黃
衡	行 刀 田 大	彳 刀 田 大 亍
鴴	行 鳥
蘅	草 衡	艸 衡	艹 衡
鑅	金 榮	釒 榮
堼	封 土
噷	口 歆
叿	口 工
吽	口 牛
呍	口 云
灴	火 工
轰	车 又 又
哄	口 共
訇	勹 言
烘	火 共
軣	車 丷 八
揈	手 訇	扌 訇	才 訇
渹	水 訇	氵 訇
焢	火 空
硡	石 宏
谾	谷 空
薨	草 网 冖 死	艸 罒 冖 死	艹 罒 冖 死
輷	車 訇
嚝	口 廣
鍧	金 訇	釒 訇
轟	車 車 車
仜	人 工	亻 工
弘	弓 厶
妅	女 工
红	丝 工	纟 工
吰	口 厷
宏	宀 厷
汯	水 厷	氵 厷
玒	玉 工	王 工
纮	丝 厷	纟 厷
闳	门 厷
宖	宀 弘
泓	水 弘	氵 弘
玜	玉 公	王 公
苰	草 弘	艸 弘	艹 弘
垬	土 共
娂	女 共
洪	水 共	氵 共
竑	立 厷
紅	絲 工	糹 工	糸 工
荭	草 红	艸 红	艹 红
虹	虫 工
虹	蟲 工	虫 工
浤	水 宏	氵 宏
紘	絲 厷	糹 厷	糸 厷
翃	厷 羽
耾	耳 厷
硔	石 共
紭	絲 弘	糹 弘	糸 弘
谹	谷 厷
鸿	水 工 鸟	氵 工 鸟
渱	水 虹	氵 虹
竤	立 宏
粠	米 共
葒	草 紅	艸 紅	艹 紅
葓	草 洪	艸 洪	艹 洪
鈜	金 厷	釒 厷
閎	門 厷
綋	絲 宏	糹 宏	糸 宏
翝	宏 羽
谼	谷 共
潂	水 山 並	氵 山 並
鉷	金 共	釒 共
鞃	革 弘
魟	魚 工
鋐	金 宏	釒 宏
彋	弓 睘
蕻	草 镸 共	艸 镸 共	艹 镸 共
霐	雨 泓
黉	小 冖 黄
霟	雨 洪
鴻	水 工 鳥	氵 工 鳥
黌	臼 爻 冖 黃	𦥯 黃
晎	日 共
嗊	口 貢
讧	言 工	讠 工
訌	言 工	訁 工
閧	門 共
撔	手 景	扌 景	才 景
澋	水 景	氵 景
澒	水 項	氵 項
銾	金 汞	釒 汞
闂	門 卷
鬨	鬥 共
闀	門 巷
齁	鼻 句
侯	人 乛 一 矢	亻 乛 一 矢
矦	厃 矢
鄇	侯 邑	侯 阝
喉	口 侯
帿	巾 侯
猴	犬 侯	犭 侯
葔	草 侯	艸 侯	艹 侯
瘊	病 侯	疒 侯
睺	目 侯
篌	竹 侯
糇	米 侯
翭	羽 侯
骺	骨 后
翵	羽 鳥
鍭	金 侯	釒 侯
餱	食 侯
鯸	魚 侯
吼	口 孔
犼	犬 孔	犭 孔
后	厂 一 口
郈	后 邑	后 阝
厚	厂 日 子
垕	后 土
後	彳 幺 夂	彳 幺 夕
洉	水 后	氵 后
逅	辵 后	辶 后
候	人 丨 乛 一 矢	亻 丨 乛 一 矢	侯 丨
堠	土 侯
豞	豕 句
鲎	小 冖 鱼	丶 丶 丶 冖 鱼
鲘	鱼 后
鮜	魚 后
鱟	臼 爻 冖 魚	𦥯 魚
乎	丿 丷 一 亅
匢	匚 勿
虍	丨 一 厂 七
呼	口 乎
垀	土 乎
忽	勿 心
昒	日 勿
曶	勿 曰	勿 日
泘	水 乎	氵 乎
苸	草 乎	艸 乎	艹 乎
恗	心 夸	忄 夸
烀	火 乎
轷	车 乎
匫	匚 曶
唿	口 忽
惚	心 忽	忄 忽
淴	水 忽	氵 忽
虖	虎 乎	虍 乎
軤	車 乎
嘑	口 虖
寣	宀 爿 言
滹	水 虖	氵 虖
雐	虎 隹	虍 隹
幠	巾 無
戯	虚 戈
歑	虖 欠
膴	肉 無	月 無
謼	言 虖	訁 虖
囫	囗 勿
抇	手 日	扌 日	才 日
弧	弓 瓜
狐	犬 瓜	犭 瓜
瓳	古 瓦
胡	古 肉	古 月
胡	古 月
壶	士 冖 业
隺	冖 隹
壷	士 冖 亜
斛	角 斗
焀	火 谷
喖	口 枯
壺	士 冖 十	士 冖 亞
媩	女 胡
搰	手 骨	扌 骨	才 骨
湖	水 胡	氵 胡
猢	犬 胡	犭 胡
絗	絲 回	糹 回	糸 回
葫	草 胡	艸 胡	艹 胡
楜	木 胡
煳	火 胡
瑚	玉 胡	王 胡
嘝	口 斛
蔛	草 斛	艸 斛	艹 斛	草 角 斗	艸 角 斗	艹 角 斗
鹕	胡 鸟
槲	木 斛
箶	竹 胡
糊	米 胡
蝴	虫 胡
蝴	蟲 胡	虫 胡
衚	行 胡	彳 胡 亍
魱	魚 互
縠	士 冖 系 殳
螜	士 冖 殳 虫
螜	士 冖 殳 蟲	士 冖 殳 虫
醐	酉 胡
頶	告 頁
觳	士 冖 角 殳
鍸	金 胡	釒 胡
餬	食 胡	飠 胡
鵠	告 鳥
瀫	水 縠	氵 縠
鬍	髟 胡
鰗	魚 胡
鶘	胡 鳥
鶦	胡 鳥
乕	厂 一 巿	厂 二 巾
汻	水 午	氵 午
虎	虍 儿
浒	水 许	氵 许
俿	人 虎	亻 虎
唬	口 虎
萀	草 虎	艸 虎	艹 虎
琥	玉 虎	王 虎
虝	虎 勿
滸	水 許	氵 許
互	一 彑
弖	弓 一
戶	丿 尸	一 尸 戸
户	丶 尸
戸	一 尸
冱	冰 互	冫 互
冴	冰 牙	冫 牙
芐	草 下	艸 下	艹 下
帍	戶 巾	户 巾	戸 巾
护	手 户	扌 户	才 户
沍	水 互	氵 互
沪	水 户	氵 户
岵	山 古
怙	心 古	忄 古
戽	戶 斗
戽	户 斗
昈	日 戶
昈	日 户
枑	木 互
怘	古 心
祜	示 古	礻 古
笏	竹 勿
婟	女 固
扈	戶 邑	户 邑	戸 邑
瓠	夸 瓜
楛	木 苦
嗀	士 冖 一 口 殳
綔	夸 系
鄠	雩 邑	雩 阝
雽	雨 乎
嫭	女 虖
嫮	女 雩
摢	手 虖	扌 虖	才 虖
滬	水 戶 邑	氵 戶 邑
蔰	草 扈	艸 扈	艹 扈
槴	木 扈
熩	火 扈
鳸	戶 鳥
簄	竹 扈
鍙	洪 金
嚛	口 樂
鹱	鸟 蒦
護	言 蒦	訁 蒦
鳠	鱼 蒦
韄	革 蒦
頀	音 蒦
鱯	魚 蒦
鸌	鳥 蒦
花	草 化	艸 化	艹 化
芲	草 人 七	艸 人 七	艹 人 七
哗	口 华
嘩	口 華
錵	金 花	釒 花
蘤	草 白 為	艸 白 為	艹 白 為
华	化 十
姡	女 舌
骅	马 华
華	草 一 草 一 十	艸 一 艹 一 十	艹 一 艹 一 十
釪	金 于	釒 于
釫	金 亏	釒 亏
铧	金 华	钅 华
滑	水 骨	氵 骨
猾	犬 骨	犭 骨
搳	手 害	扌 害	才 害
磆	石 骨
蕐	草 二 人 人 人 人 十	艸 二 人 人 人 人 十	艹 二 人 人 人 人 十
螖	虫 骨
螖	蟲 骨	虫 骨
鋘	金 吳	釒 吳
譁	言 華	訁 華
鏵	金 華	釒 華
驊	馬 華
鷨	華 鳥
化	人 匕	亻 匕
划	戈 刀	戈 刂
杹	木 化
画	一 由 凵
话	言 舌	讠 舌
桦	木 华
婳	女 画
畫	聿 田 一
嬅	女 華
畵	聿 田 凵
觟	角 圭
話	言 舌	訁 舌
劃	畫 刀	畫 刂
摦	手 瓠	扌 瓠	才 瓠
樺	木 華
嫿	女 畫
槬	木 瓠
澅	水 畫	氵 畫
諙	言 昏	訁 昏
諣	言 咼	訁 咼
黊	黄 圭
黊	黃 圭
繣	絲 畫	糹 畫	糸 畫
舙	舌 舌 舌
譮	言 會	訁 會
怀	心 不	忄 不
徊	彳 回
淮	水 隹	氵 隹
槐	木 鬼
褢	衣 鬼
踝	足 果
懐	心 十 目 衣	忄 十 网 衣	忄 十 罒 衣
褱	衣 目 二 丨 二	衣 网 二 丨 二	衣 罒 二 丨 二	衣 目 丨 丷 八
懷	心 褱	忄 褱
瀤	水 褱	氵 褱
櫰	木 褱
耲	耒 褱
蘹	草 懷	艸 懷	艹 懷
坏	土 不
咶	口 舌
壊	土 十 目 衣	土 十 网 衣	土 十 罒 衣
壞	土 褱
蘾	草 壞	艸 壞	艹 壞
欢	又 欠
犿	犬 卞	犭 卞
歓	丿 二 隹 欠
鴅	丹 鳥
鵍	完 鳥
酄	雚 邑	雚 阝
嚾	口 雚
懽	心 雚	忄 雚
獾	犬 雚	犭 雚
歡	雚 欠
讙	言 雚	訁 雚
貛	豸 雚
驩	馬 雚
环	玉 不	王 不
郇	旬 邑	旬 阝
峘	山 亘
洹	水 亘	氵 亘
狟	犬 亘	犭 亘
荁	草 亘	艸 亘	艹 亘
桓	木 亘
萈	草 見 丶	艸 見 丶	艹 見 丶
萑	草 隹	艸 隹	艹 隹
寏	宀 奐
絙	絲 亘	糹 亘	糸 亘
雈	草 隹	艸 隹	艹 隹
綄	絲 完	糹 完	糸 完
羦	羊 完
貆	豸 亘
鉮	金 申	釒 申
锾	金 爰	钅 爰
圜	囗 睘
嬛	女 睘
寰	宀 睘
澴	水 睘	氵 睘
缳	丝 睘	纟 睘
阛	门 睘
環	玉 睘	王 睘
豲	豕 原
鍰	金 爰	釒 爰
镮	金 睘	钅 睘
鹮	睘 鸟
糫	米 睘
繯	絲 睘	糹 睘	糸 睘
轘	車 睘
鐶	金 睘	釒 睘
闤	門 睘
鬟	髟 睘
瓛	玉 獻	王 獻
缓	丝 爰	纟 爰
緩	絲 爰	糹 爰	糸 爰
攌	手 圜	扌 圜	才 圜
幻	幺 乛
奂	刀 冂 大
肒	肉 丸	月 丸
奐	刀 冂 儿 大
宦	宀 臣
唤	口 奂
换	手 奂	扌 奂	才 奂
浣	水 完	氵 完
涣	水 奂	氵 奂
烉	刀 冂 八 火
患	串 心
梙	木 串
焕	火 奂
逭	辵 官	辶 官
喚	口 奐
喛	口 爰
嵈	山 爰
愌	心 奐	忄 奐
換	手 奐	扌 奐	才 奐
渙	水 奐	氵 奐
痪	病 奂	疒 奂
睆	目 完
煥	火 奐
瑍	玉 奐	王 奐
豢	八 夫 豕	丷 夫 豕	𠔉 豕
漶	水 患	氵 患
瘓	病 奐	疒 奐
槵	木 患
鲩	鱼 完
擐	手 睘	扌 睘	才 睘
澣	水 幹	氵 幹
藧	草 緩	艸 緩	艹 緩
鯇	魚 完
鯶	魚 軍
鰀	魚 爰
巟	亡 川
肓	亡 肉	亡 月
荒	草 巟	艸 巟	艹 巟
衁	亡 血
朚	亡 明
塃	土 荒
慌	心 荒	忄 荒
皇	白 王
偟	人 皇	亻 皇
凰	几 皇
隍	阜 皇	阝 皇
黄	艹 一 田 八
喤	口 皇
堭	土 皇
媓	女 皇
崲	山 皇
徨	彳 皇
惶	心 皇	忄 皇
湟	水 皇	氵 皇
葟	草 皇	艸 皇	艹 皇
遑	辵 皇	辶 皇
黃	廿 一 田 八
楻	木 皇
煌	火 皇
瑝	玉 皇	王 皇
墴	土 黄
墴	土 黃
潢	水 黄	氵 黄
潢	水 黃	氵 黃
獚	犬 黄	犭 黄
獚	犬 黃	犭 黃
锽	金 皇	钅 皇
熿	火 黄
熿	火 黃
璜	玉 黄	王 黄
璜	玉 黃	王 黃
篁	竹 皇
篊	竹 洪
艎	舟 皇
蝗	虫 皇
蝗	蟲 皇	虫 皇
癀	病 黄	疒 黄
癀	病 黃	疒 黃
磺	石 黄
磺	石 黃
穔	禾 黄
穔	禾 黃
諻	言 皇	訁 皇
簧	竹 黄
簧	竹 黃
蟥	虫 黄
蟥	蟲 黃	虫 黃
鍠	金 皇	釒 皇
餭	食 皇
鳇	鱼 皇
趪	走 黄
趪	走 黃
韹	音 皇
鐄	金 黃	釒 黃
騜	馬 皇
鰉	魚 皇
鱑	魚 黃
鷬	黃 鳥
怳	心 兄	忄 兄
恍	心 光	忄 光
炾	火 兄
宺	宀 口 一 川	向 一 川
晃	日 光
晄	日 光
奛	大 明
谎	言 荒	讠 荒
幌	巾 晃
詤	言 亾 川	訁 亾 川
熀	火 晃
謊	言 荒	訁 荒
櫎	木 廣
兤	光 廣
愰	心 晃	忄 晃
滉	水 晃	氵 晃
榥	木 晃
曂	日 黄
曂	日 黃
皝	皇 光
鎤	金 晃	釒 晃
皩	皇 晃
灰	厂 火	一 丿 火
诙	言 灰	讠 灰
咴	口 灰
恢	心 灰	忄 灰
拻	手 灰	扌 灰	才 灰
挥	手 军	扌 军	才 军
洃	水 灰	氵 灰
虺	兀 虫
虺	兀 蟲	兀 虫
袆	衣 韦	衤 韦
晖	日 军
烣	火 灰
珲	玉 军	王 军
豗	兀 豕
婎	女 隹
揮	手 軍	扌 軍	才 軍
翚	羽 军
辉	车 军
隓	阜 左 左	阝 左 左
暉	日 軍
楎	木 軍
煇	火 軍
禈	示 軍	礻 軍
詼	言 灰	訁 灰
幑	彳 山 帀 攴	彳 山 帀 攵
睳	目 奎
褘	衣 韋	衤 韋
噅	口 為
撝	手 爲	扌 爲	才 爲
噕	爲 口
翬	羽 軍
輝	車 軍
麾	麻 毛
徽	彳 山 糸 攴	彳 山 糸 攵
隳	阜 隋 人 心	阝 隋 人 心	阜 隋 人 小 丶	阝 隋 人 小 丶
瀈	水 翬	氵 翬
蘳	草 黊	艸 黊	艹 黊
鰴	彳 山 一 魚 攴	彳 山 一 魚 攵
囘	冂 巳	冂 已
回	囗 口
囬	囗 丨 丨 一 一
佪	人 回	亻 回
廻	廴 回
廽	廴 囬
恛	心 回	忄 回
洄	水 回	氵 回
茴	草 回	艸 回	艹 回
迴	辵 回	辶 回
烠	火 有
蚘	虫 尤
蚘	蟲 尤	虫 尤
逥	辵 囬	辶 囬
痐	病 回	疒 回
蛔	虫 回
蛔	蟲 回	虫 回
蛕	虫 有
蛕	蟲 有	虫 有
蜖	蟲 囬	虫 囬
鮰	魚 回
悔	心 每	忄 每
毀	臼 土 殳
毁	臼 工 殳
毇	臼 米 殳
檓	木 毀
燬	火 毀
譭	言 毀	訁 毀
卉	十 廾
汇	水 匚	氵 匚
会	人 云
讳	言 韦	讠 韦
泋	水 卉	氵 卉
哕	口 岁
浍	水 会	氵 会
绘	丝 会	纟 会
芔	屮 屮 屮	屮 艸
荟	草 会	艸 会	艹 会
诲	言 每	讠 每
恚	圭 心
恵	一 由 心
烩	火 会
贿	贝 有
彗	丰 丰 彐
晦	日 每
秽	禾 岁
喙	口 彖
惠	叀 心
惠	叀 心	一 由 厶 心
湏	水 頁	氵 頁
絵	絲 会	糹 会	糸 会
缋	丝 贵	纟 贵
翙	岁 羽
阓	门 贵
匯	匚 淮
彙	彑 冖 果
彚	彐 冖 果
會	人 一 口 丨 丷 曰
滙	水 匚 隹	氵 匚 隹
詯	言 自	訁 自
賄	貝 有
颒	水 廾 页
僡	人 惠	亻 惠
嘒	口 彗
瘣	病 鬼	疒 鬼
蔧	草 彗	艸 彗	艹 彗
誨	言 每	訁 每
圚	囗 貴
寭	宀 惠
慧	彗 心
憓	心 惠	忄 惠
暳	日 彗
槥	木 彗
潓	水 惠	氵 惠
蕙	草 惠	艸 惠	艹 惠
噦	口 歲
嬒	女 會
徻	彳 會
橞	木 惠
殨	歹 貴
澮	水 會	氵 會
濊	水 歲	氵 歲
獩	犬 歲	犭 歲
薈	草 會	艸 會	艹 會
薉	草 歲	艸 歲	艹 歲
諱	言 韋	訁 韋
頮	水 廾 頁
檅	木 歲
燴	火 會
璯	玉 會	王 會
篲	竹 彗
藱	草 廆	艸 廆	艹 廆
餯	食 彖
嚖	口 慧
瞺	目 會
穢	禾 歲
繢	絲 貴	糹 貴	糸 貴
蟪	虫 惠
蟪	蟲 惠	虫 惠
櫘	木 慧
繪	絲 會	糹 會	糸 會
翽	歲 羽
譓	言 惠	訁 惠
儶	人 巂	亻 巂
鏸	金 惠	釒 惠
闠	門 貴
孈	女 巂
鐬	金 歲	釒 歲
靧	面 貴
譿	言 慧	訁 慧
顪	歲 頁
昏	氏 日
昬	民 日
荤	草 军	艸 军	艹 军
婚	女 昏
惛	心 昏	忄 昏
涽	水 昏	氵 昏
阍	门 昏
棔	木 昏
殙	歹 昏
葷	草 軍	艸 軍	艹 軍
睧	目 昏
睯	敃 目
閽	門 昏
忶	心 云	忄 云
浑	水 军	氵 军
梡	木 完
馄	食 昆	饣 昆
堚	土 軍
渾	水 軍	氵 軍
琿	玉 軍	王 軍
魂	云 鬼
餛	食 昆	飠 昆
繉	絲 目 兆	糹 目 兆	糸 目 兆
轋	車 連
鼲	鼠 軍
诨	言 军	讠 军
俒	人 完	亻 完
倱	人 昆	亻 昆
圂	囗 豕
掍	手 昆	扌 昆	才 昆
混	水 昆	氵 昆
焝	火 昏
溷	水 圂	氵 圂
慁	圂 心
觨	角 汞
諢	言 軍	訁 軍
吙	口 火
剨	砉 刀	砉 刂
耠	耒 合
锪	金 忽	钅 忽
劐	蒦 刀	蒦 刂
嚄	口 蒦
鍃	金 忽	釒 忽
豁	害 谷
攉	手 霍	扌 霍	才 霍
騞	馬 砉
佸	人 舌	亻 舌
活	水 舌	氵 舌
秮	禾 台
秳	禾 舌
火	丷 人
伙	人 火	亻 火
邩	火 邑	火 阝
钬	金 火	钅 火
鈥	金 火	釒 火
漷	水 郭	氵 郭
夥	果 多
沎	水 化	氵 化
或	口 一 戈
货	化 贝
咟	口 百
砉	丰 石
俰	人 和	亻 和
捇	手 赤	扌 赤	才 赤
眓	目 戉
获	草 犬 犬	艸 犭 犬	艹 犭 犬
閄	門 人
掝	手 或	扌 或	才 或
祸	示 呙	礻 呙	示 口 内
貨	化 貝
惑	或 心
旤	咼 旡
楇	木 咼
湱	水 砉	氵 砉
禍	示 咼	礻 咼
蒦	草 隻	草 隹 又	艸 隻	艹 隻
奯	大 歲
濩	水 蒦	氵 蒦
獲	犬 蒦	犭 蒦	犬 草 隹 又
霍	雨 隹
檴	木 蒦
謋	言 桀	訁 桀
矆	目 蒦
穫	禾 蒦	禾 草 隹 又
镬	金 蒦	钅 蒦
嚯	口 霍
瀖	水 霍	氵 霍
耯	耒 蒦
艧	舟 蒦
藿	草 霍	艸 霍	艹 霍
蠖	虫 蒦
蠖	蟲 蒦	虫 蒦
嚿	口 舊
曤	日 霍
臛	肉 霍	月 霍
癨	病 霍	疒 霍
矐	目 霍
鑊	金 蒦	釒 蒦
靃	雨 雔	雨 隹 隹
丌	一 丿 丨
讥	言 几	讠 几
击	二 山
刉	乞 刀	乞 刂
叽	口 几
饥	饣 几
饥	食 几	饣 几
乩	占 乙
乩	占 乙	占 乚
刏	气 刀	气 刂
圾	土 及
机	木 几
玑	玉 几	王 几
肌	肉 几	月 几
芨	草 及	艸 及	艹 及
矶	石 几
鸡	又 鸟
枅	木 开
咭	口 吉
姫	女 臣
迹	辵 亦	辶 亦
剞	奇 刀	奇 刂
唧	口 即
姬	女 匚 丨 口 丨
屐	尸 彳 支
积	禾 只
笄	竹 开
飢	食 几	飠 几
基	其 土
绩	丝 责	纟 责
喞	口 卽
嵆	禾 尤 山
嵇	禾 尤 山
敧	奇 攴
朞	其 月
犄	牛 奇	牜 奇
筓	竹 幵
缉	丝 咠	纟 咠	丝 口 耳
赍	十 人 人 冖 贝
勣	責 力
嗘	口 奚
畸	田 奇
稘	禾 其
跡	足 亦
跻	足 齐
鳮	又 鳥
僟	人 幾	亻 幾
毄	車 口 殳
箕	竹 其
銈	金 圭	釒 圭
嘰	口 幾
撃	車 殳 手
槣	木 寄
畿	幺 幺 戈 田	幾 田
稽	禾 尤 旨
緝	絲 咠	糹 咠	糸 咠
觭	角 奇
賫	十 人 人 冖 貝
躸	身 奇
齑	文 丿 丨 韭
墼	車 凵 殳 土
機	木 幾
激	水 敫	氵 敫
璣	玉 幾	王 幾
禨	示 幾	礻 幾
積	禾 責
襀	衣 責	衤 責
錤	金 其	釒 其
隮	阜 齊	阝 齊
擊	車 凵 殳 手
磯	石 幾
簊	竹 基
績	絲 責	糹 責	糸 責
羁	网 革 马	罒 革 马
賷	十 口 口 冖 貝
鄿	蕇 邑	蕇 阝
櫅	木 齊
耭	耒 幾
蹟	辵 亦 迹	辶 亦 迹
蹟	足 責
雞	奚 隹
譏	言 幾	訁 幾
韲	亠 丫 刀 丿 𠄌 乁 韭
鶏	爪 夫 鳥	爫 夫 鳥
譤	言 敫	訁 敫
鐖	金 幾	釒 幾
饑	食 幾
躋	足 齊
鞿	革 幾
鷄	奚 鳥
齎	齊 貝
羇	网 革 奇	罒 革 奇
虀	草 韲	艸 韲	艹 韲
鑇	金 齊	釒 齊
覉	西 革 奇	覀 革 奇
鑙	金 禾 尤 旨	釒 禾 尤 旨
齏	亠 丫 刀 丿 𠄌 乁 丿 丨 二 韭
羈	网 革 馬	罒 革 馬
鸄	敫 鳥
覊	西 革 馬	襾 革 馬	覀 革 馬
亼	人 一
及	乃 乀
伋	人 及	亻 及
吉	士 口
岌	山 及
彶	彳 及
忣	心 及	忄 及
汲	水 及	氵 及
级	丝 及	纟 及
即	艮 卩
极	木 及
皀	白 匕
亟	丂 口 又 一
亟	了 口 又 一
佶	人 吉	亻 吉
诘	言 吉	讠 吉
郆	吉 邑	吉 阝
卽	白 匕 卩
叝	去 及
姞	女 吉
急	刍 心
狤	犬 吉	犭 吉
皍	白 匕 卩
笈	竹 及
級	絲 及	糹 及	糸 及
揤	手 即	扌 即	才 即
揤	手 即	扌 即	才 即
疾	病 矢	疒 矢
脊	肉 人 二 二	月 人 二 二
觙	角 及
偮	人 咠	亻 咠
卙	甚 十
庴	广 昔
焏	了 口 又 火	了 口 又 灬
谻	谷 卂 一
戢	口 耳 戈
棘	朿 朿
極	木 亟
殛	歹 亟
湒	水 咠	氵 咠
集	隹 木
塉	土 脊
嫉	女 疾
愱	心 疾	忄 疾
楫	木 咠	木 口 耳
蒺	草 疾	艸 疾	艹 疾
趌	走 吉
辑	车 咠	车 口 耳
槉	木 疾
耤	耒 昔
膌	肉 脊	月 脊
銡	金 吉	釒 吉
嶯	山 戢
潗	水 集	氵 集
濈	水 戢	氵 戢
瘠	病 脊	疒 脊
箿	竹 咠
蕀	草 棘	艸 棘	艹 棘
蕺	草 戢	艸 戢	艹 戢
踖	足 昔
鹡	脊 鸟
橶	木 戟
檝	木 戢
螏	虫 疾
螏	蟲 疾	虫 疾
輯	車 咠	車 口 耳
藉	草 耤	艸 耤	艹 耤
襋	衣 棘	衤 棘
蹐	足 脊
鍓	金 咠	釒 咠
艥	舟 咠 戈
籍	竹 耤
轚	車 凵 殳
鏶	金 集	釒 集
霵	雨 戢
鶺	脊 鳥
鷑	笠 鳥
躤	足 藉
雦	隹 隹 隹
雧	集 集 集 木
几	丿 一 乚
几	丿 乙
己	乛 一 乚
丮	乙 二 丨
妀	己 女
犱	犬 丸	犭 丸
泲	水 丿 乛 丨 丿	氵 丿 乛 丨 丿	水 𠂔	氵 𠂔
虮	虫 几
挤	手 齐	扌 齐	才 齐
掎	手 奇	扌 奇	才 奇
鱾	鱼 己
幾	幺 幺 戈 人	幺 幺 戍
戟	十 早 戈
嵴	山 脊
麂	鹿 几
魢	魚 己
撠	手 戟	扌 戟	才 戟
擠	手 齊	扌 齊	才 齊
穖	禾 幾
蟣	蟲 幾	虫 幾
魕	鬼 幾
旡	厂 尢	匚 丿 乚
计	言 十	讠 十
记	言 己	讠 己
伎	人 支	亻 支
纪	丝 己	纟 己
坖	土 元
妓	女 支
忌	己 心
技	手 支	扌 支	才 支
芰	草 支	艸 支	艹 支
际	阜 示	阝 示
剂	齐 刀	齐 刂
季	禾 子
哜	口 齐
垍	土 自
峜	山 企
既	艮 旡
洎	水 自	氵 自
济	水 齐	氵 齐
紀	絲 己	糹 己	糸 己
茍	草 句	艸 句	艹 句
茤	草 多	艸 多	艹 多
荠	草 齐	艸 齐	艹 齐
計	言 十	訁 十
剤	斉 刀	斉 刂
紒	絲 介	糹 介	糸 介
继	丝 丨 一 米	纟 丨 一 米	纟 𠃊 米
觊	岂 见
記	言 己	訁 己
偈	人 曷	亻 曷
寂	宀 叔
寄	宀 奇
徛	彳 奇
悸	心 季	忄 季
旣	白 匕 旡
梞	木 忌
済	水 斉	氵 斉
祭	夗 示
塈	既 土
惎	其 心
臮	自 丅 人 人
葪	草 角 刀	艸 角 刂	艹 角 刂
蔇	草 既	艸 既	艹 既
兾	丷 異
痵	病 季	疒 季
蓟	草 鱼 刀	艸 鱼 刂	艹 鱼 刂
裚	折 衣
際	阜 祭	阝 祭
鬾	鬼 支
暨	既 旦
漃	水 寂	氵 寂
漈	水 祭	氵 祭
禝	示 畟	礻 畟
稩	禾 胃
穊	禾 既
誋	言 忌	訁 忌
跽	足 忌
霁	雨 齐
鲚	鱼 齐
暩	日 祭
稷	禾 田 儿 夕	禾 田 儿 夂	禾 畟
諅	其 言
鲫	鱼 即
冀	北 異
劑	齊 刀	齊 刂
曁	旣 旦
穄	禾 祭
薊	草 魚 刀	艸 魚 刂	艹 魚 刂
髻	髟 吉
嚌	口 齊
檕	車 凵 殳 木
濟	水 齊	氵 齊
繋	軗 糸
罽	网 厂 剡	罒 厂 剡
薺	草 齊	艸 齊	艹 齊
覬	豈 見
檵	木 丨 一 幺 幺 一 幺 幺
鵋	忌 鳥
齌	齊 火
懻	心 冀	忄 冀
癠	病 齊	疒 齊
穧	禾 齊
蘎	草 雨 肥	艸 雨 肥	艹 雨 肥
骥	马 冀
鯚	魚 季
瀱	水 罽	氵 罽
繼	絲 丨 一 幺 幺 一 幺 幺	糹 丨 一 幺 幺 一 幺 幺	糸 丨 一 幺 幺 一 幺 幺	糸 𠃊 幺 幺 一 幺 幺
蘮	草 罽	艸 罽	艹 罽
鱀	既 魚
蘻	草 繫	艸 繫	艹 繫
霽	雨 齊
鰶	魚 祭
鰿	魚 責
鱭	魚 齊
驥	馬 冀
加	力 口
乫	加 乙
夹	一 丷 大
伽	人 加	亻 加
夾	大 人 人
抸	手 乏	扌 乏	才 乏
佳	人 圭	亻 圭	人 土 土	亻 土 土
拁	手 加	扌 加	才 加
泇	水 加	氵 加
茄	草 加	艸 加	艹 加
迦	辵 加	辶 加
枷	木 加
毠	加 毛
浃	水 夹	氵 夹
珈	玉 加	王 加
埉	土 夾
家	宀 豕
浹	水 夾	氵 夾
痂	病 加	疒 加
梜	木 夾
笳	竹 加
耞	耒 加
袈	加 衣
傢	人 家	亻 家
猳	犬 叚	犭 叚
葭	草 叚	艸 叚	艹 叚
跏	足 加
犌	牛 叚	牜 叚
腵	肉 叚	月 叚
鉫	金 加	釒 加
嘉	吉 丷 一 加	士 口 丷 一 加
鉿	金 合	釒 合
镓	金 家	钅 家
豭	豕 叚
貑	豸 叚
鎵	金 家	釒 家
麚	鹿 叚
圿	土 介
忦	心 介	忄 介
扴	手 介	扌 介	才 介
郏	夹 邑	夹 阝
荚	草 夹	艸 夹	艹 夹
郟	夾 邑	夾 阝
唊	口 夾
恝	丰 刀 心
莢	草 夾	艸 夾	艹 夾
戛	一 自 戈
铗	金 夹	钅 夹
戞	百 冖 戈
蛱	虫 夹
裌	衣 夾	衤 夾
颊	夹 页
蛺	蟲 夾	虫 夾
跲	足 合
餄	食 合	飠 合
鋏	金 夾	釒 夾
頬	夹 頁
頰	夾 頁
鴶	吉 鳥
鵊	夾 鳥
甲	囗 十
岬	山 甲
玾	玉 甲	王 甲
胛	肉 甲	月 甲
斚	厶 厶 冖 斗
贾	西 贝	覀 贝	襾 贝
钾	金 甲	钅 甲
假	人 叚	亻 叚
婽	女 叚
徦	彳 叚
斝	口 口 冖 斗
椵	木 叚
賈	西 貝	覀 貝	襾 貝
鉀	金 甲	釒 甲
榎	木 夏
槚	木 贾
瘕	病 叚	疒 叚
檟	木 賈
价	人 介	亻 介
驾	加 马
架	加 木
嫁	女 家
幏	巾 家
榢	木 家
價	人 賈	亻 賈
稼	禾 家
駕	加 馬
戋	戈 一
奸	女 干
尖	小 大
幵	干 干	千 干
坚	丨 丨 又 土
歼	歹 千
间	门 日
冿	冰 聿	冫 聿
戔	戈 戈
玪	玉 今	王 今
肩	戶 肉	戶 月	户 月	戸 月
艰	又 艮
姦	女 女 女
姧	女 女 干
兼	丷 一 彐 丨 丨 八	丷 一 聿 丨 丨 八	丷 一 肀 丨 丨 八
监	丨 丨 丿 一 丶 皿
堅	臤 土
惤	心 弦	忄 弦
猏	犬 肩	犭 肩
笺	竹 戋
菅	草 官	艸 官	艹 官
菺	草 肩	艸 肩	艹 肩
豜	豕 开
湔	水 前	氵 前
牋	片 戔
犍	牛 建	牜 建
缄	丝 咸	纟 咸
葌	草 姦	艸 姦	艹 姦
間	門 日
搛	手 兼	扌 兼	才 兼
椷	木 咸
椾	木 前
煎	前 火	前 灬
瑊	玉 咸	王 咸
睷	目 建
碊	石 戔
缣	丝 兼	纟 兼
蒹	草 兼	艸 兼	艹 兼
豣	豕 幵
監	臣 丿 一 丶 皿
箋	竹 戔
樫	木 堅
熞	火 堅
緘	絲 咸	糹 咸	糸 咸
蕑	草 閒	艸 閒	艹 閒
蕳	草 間	艸 間	艹 間
鲣	鱼 坚
鳽	开 鳥
鹣	兼 鸟
熸	火 旡 旡 日	火 朁
篯	竹 戋
縑	絲 兼	糹 兼	糸 兼
艱	革 大 艮
鞬	革 建
餰	食 衍
馢	香 戔
麉	干 干 鹿
瀐	水 韯	氵 韯
鞯	革 荐
鳒	鱼 兼
礛	石 監
覸	間 見
鵳	肩 鳥
瀸	水 韱	氵 韱
鐧	金 間	釒 間
櫼	木 韱
殲	歹 韱	歹 人 人 戈 韭
鶼	兼 鳥
韀	革 廌
鰹	魚 堅
囏	革 大 喜
虃	草 韱	艸 韱	艹 韱
鑯	金 韱	釒 韱
韉	革 薦
囝	囗 子
拣	手 东 一	扌 东 一	才 东 一
枧	木 见
俭	人 佥	亻 佥
柬	木 口 丷	木 囗 丷
茧	草 虫
倹	人 人 一 口 人	亻 人 一 口 人
挸	手 見	扌 見	才 見
捡	手 佥	扌 佥	才 佥
笕	竹 见
减	冰 咸	冫 咸
剪	前 刀
梘	木 見
检	木 佥
湕	水 建	氵 建
趼	足 开
堿	土 咸
揀	手 柬	扌 柬	才 柬
揃	手 前	扌 前	才 前
検	木 人 一 口 人
減	水 咸	氵 咸
睑	目 佥
硷	石 佥
裥	衣 间	衤 间
詃	言 玄	訁 玄
锏	金 间	钅 间
弿	宀 井 大 弓
暕	日 柬
瑐	玉 前	王 前
筧	竹 見
简	竹 间
絸	絲 見	糹 見	糸 見
谫	言 剪	讠 剪
戩	晉 戈
戬	晋 戈
碱	石 咸
儉	人 僉	亻 僉
翦	前 羽
撿	手 僉	扌 僉	才 僉
檢	木 僉
藆	草 搴	艸 搴	艹 搴
襇	衣 間	衤 間
襉	衣 閒	衤 閒
謇	宀 井 大 言
蹇	宀 井 大 足
瞼	目 僉
礆	石 僉
簡	竹 間
繭	草 冂 丨 絲 蟲	草 冂 丨 糸 虫	艹 虫 茧	艸 冂 丨 糸 虫	艹 冂 丨 糸 虫
謭	言 剪	訁 剪
鬋	髟 前
鰎	魚 建
鹸	鹵 人 一 口 人
瀽	水 蹇	氵 蹇
蠒	爾 蟲	爾 虫
鐗	金 閒	釒 閒
劗	贊 刀	贊 刂
鹻	鹵 兼
籛	竹 戔
譾	言 翦	訁 翦
襺	衣 繭	衤 繭
鹼	鹵 僉
见	冂 丿 乚
件	人 牛	亻 牛
見	目 儿
建	廴 聿
饯	食 戋	饣 戋
剑	佥 刀	佥 刂
洊	水 存	氵 存
牮	代 牛
荐	草 存	艸 存	艹 存
贱	贝 戋
俴	人 戔	亻 戔
健	人 建	亻 建
剣	人 一 口 人 刀	人 一 口 人 刂
栫	木 存
涧	水 间	氵 间
珔	玉 存	王 存
舰	舟 见
剱	人 一 口 人 刄
徤	彳 建
渐	水 斩	氵 斩
袸	衣 存	衤 存
谏	言 柬	讠 柬
釼	金 刄	釒 刄
寋	宀 井 大
旔	方 建
楗	木 建
毽	毛 建
溅	水 贱	氵 贱
腱	肉 建	月 建
臶	至 存
葥	草 前	艸 前	艹 前
践	足 戋
賎	貝 一 戋
鉴	丨 丨 丿 一 丶 金	丨 丨 丿 一 丶 金
键	金 建	钅 建
僭	人 朁	亻 朁
榗	木 晉
榗	木 晋
漸	水 斬	氵 斬
蔪	草 斬	艸 斬	艹 斬
劍	僉 刀	僉 刂
劎	僉 刀
澗	水 間	氵 間
箭	竹 前
糋	米 前
諓	言 戔	訁 戔
賤	貝 戔
趝	走 念
踐	足 戔
踺	足 建
劒	僉 刃
劔	僉 刄
薦	草 廌	艸 廌	艹 廌
諫	言 柬	訁 柬
鋻	臤 金
鍵	金 建	釒 建
餞	食 戔	飠 戔
瞷	目 間
磵	石 間
螹	蟲 斬	虫 斬
鍳	臣 丿 一 丶
擶	手 箭	扌 箭	才 箭
濺	水 賤	氵 賤
繝	絲 閒	糹 閒	糸 閒
瀳	水 薦	氵 薦
覵	閒 見
鏩	金 斬	釒 斬
艦	舟 監
譼	臣 丿 一 丶 网 言	臣 丿 一 丶 罒 言
轞	車 監
鐱	金 僉	釒 僉
鑑	金 監	釒 監
鑒	臣 丿 一 丶 网 金	臣 丿 一 丶 罒 金
鑬	金 覽	釒 覽
鑳	金 蹇	釒 蹇
橺	木 間
江	水 工	氵 工
姜	羊 女
将	丬 夕 寸
茳	草 江	艸 江	艹 江
浆	丬 夕 水
畕	田 田
豇	豆 工
將	爿 肉 寸	爿 月 寸	爿 夕 寸
葁	草 姜	艸 姜	艹 姜
畺	一 田 一 田 一	三 田 田
摪	手 將	扌 將	才 將
翞	羽 京
僵	人 畺	亻 畺
漿	水 將
螀	将 虫
壃	土 畺
缰	丝 畺	纟 畺
薑	草 畺	艸 畺	艹 畺
橿	木 畺
殭	歹 畺
螿	將 蟲	將 虫
鳉	鱼 丬 夕 寸
疅	田 畺
礓	石 畺
疆	弓 土 畺
繮	絲 畺	糹 畺	糸 畺
韁	革 畺
鱂	魚 將
讲	言 井	讠 井
奖	丬 夕 大
桨	丬 夕 木
傋	人 冓	亻 冓
蒋	草 将	艸 将	艹 将
奨	将 大
蔣	草 將	艸 將	艹 將
槳	將 木
獎	將 犬
耩	耒 冓
膙	肉 強	月 強
講	言 冓	訁 冓
顜	冓 頁
匞	匚 工
匠	匚 斤
夅	夕 匚 丨	夂 匚 丨
弜	弓 弓
降	阜 夅	阝 夅
洚	水 夅	氵 夅
绛	丝 夅	纟 夅
弶	弓 京
袶	衣 夅	衤 夅
絳	絲 夅	糹 夅	糸 夅
酱	丬 夕 酉
勥	強 力
勥	强 力
滰	水 竟	氵 竟
嵹	山 強
摾	手 强	扌 强	才 强
彊	弓 畺
犟	强 牛
糡	米 竟
醤	将 酉
糨	米 強
醬	將 酉
謽	強 言
艽	草 九	艸 九	艹 九
芁	草 几	艸 几	艹 几
交	亠 父
郊	交 邑	交 阝
姣	女 交
娇	女 乔
峧	山 交
浇	水 尧	氵 尧
茭	草 交	艸 交	艹 交
茮	草 尗	艸 尗	艹 尗
骄	马 乔
胶	肉 交	月 交
椒	木 叔
焦	隹 火	隹 灬
蛟	虫 交
蛟	蟲 交	虫 交
跤	足 交
僬	人 焦	亻 焦
嘄	口 梟
虠	交 虎
鲛	鱼 交
嬌	女 喬
嶕	山 焦
嶣	山 焦	崔 火	崔 灬
憍	心 喬	忄 喬
澆	水 堯	氵 堯
膠	肉 翏	月 翏
蕉	草 焦	艸 焦	艹 焦
燋	火 焦
膲	肉 焦	月 焦
礁	石 焦
穚	禾 喬
鮫	魚 交
鵁	交 鳥
鹪	焦 鸟
簥	竹 喬
蟭	虫 焦
蟭	蟲 焦	虫 焦
轇	車 翏
鐎	金 焦	釒 焦
驕	馬 喬
鷦	焦 鳥
鷮	喬 鳥
臫	自 乙	自 乚
角	刀 用
佼	人 交	亻 交
侥	人 尧	亻 尧
恔	心 交	忄 交
挢	手 乔	扌 乔	才 乔
狡	犬 交	犭 交
绞	丝 交	纟 交
饺	食 交	饣 交
捁	手 告	扌 告	才 告
晈	日 交
烄	火 交
笅	竹 爻
皎	白 交
矫	矢 乔
脚	肉 却	月 却
铰	金 交	钅 交
搅	手 觉	扌 觉
搅	手 觉	扌 觉	才 觉
湫	水 秋	氵 秋
絞	絲 交	糹 交	糸 交
剿	巢 刀	巢 刂
敫	白 方 攴	白 方 攵
湬	秋 水
煍	火 秋
腳	肉 卻	月 卻
賋	貝 交
僥	人 堯	亻 堯
摷	手 巢	扌 巢	才 巢
暞	日 臬
踋	足 却
鉸	金 交	釒 交
餃	食 交	飠 交
儌	人 敫	亻 敫
劋	喿 刀	喿 刂
徺	彳 堯
撟	手 喬	扌 喬	才 喬
撹	手 覚	扌 覚	才 覚
隦	阜 辟	阝 辟
徼	彳 敫
憿	心 敫	忄 敫
敽	喬 攴
敿	喬 攴	喬 攵
缴	丝 敫	纟 敫
曒	日 敫
璬	玉 敫	王 敫
矯	矢 喬
皦	白 敫
蟜	蟲 喬	虫 喬
繳	絲 敫	糹 敫	糸 敫
譑	言 喬	訁 喬
孂	女 簋
攪	手 覺	扌 覺	才 覺
灚	水 覺	氵 覺
鱎	魚 喬
叫	口 丩
呌	口 斗
峤	山 乔
挍	手 交	扌 交	才 交
訆	言 丩	訁 丩
珓	玉 交	王 交
窌	穴 卯
轿	车 乔
较	车 交
敎	乂 一 丿 子 攴	乂 一 丿 子 攵
教	孝 攴	孝 攵
窖	穴 告
滘	水 冖 八 工 口	氵 冖 八 工 口	水 㓁 工 口
滘	水 冖 八 工 口	氵 冖 八 工 口	水 㓁 工 口	氵 㓁 工 口
較	車 交
嘂	吕 丩 吕	口 口 丩 口 口
嘦	只 要
斠	冓 斗
漖	水 教	氵 教
酵	酉 孝
噍	口 焦
嶠	山 喬
潐	水 焦	氵 焦
噭	口 敫
嬓	女 敫
獥	犬 敫	犭 敫
藠	草 皛	艸 皛	艹 皛
趭	走 焦
轎	車 喬
醮	酉 焦
譥	敫 言
皭	白 爵
釂	酉 爵
阶	阜 介	阝 介
疖	病 节	疒 节
皆	比 白
接	手 妾	扌 妾	才 妾
掲	手 日 勹 匕	扌 日 勹 匕	才 日 勹 匕
痎	病 亥	疒 亥
秸	禾 吉
菨	草 妾	艸 妾	艹 妾
階	阜 皆	阝 皆
喈	口 皆
喼	口 急
嗟	口 差
堦	土 皆
嫅	女 差
揭	手 曷	扌 曷	才 曷
椄	木 妾
湝	水 皆	氵 皆
街	行 圭	行 土 土	彳 圭 亍	
稭	禾 皆
鞂	革 和
擑	手 戢	扌 戢	才 戢
蝔	虫 皆
蝔	蟲 皆	虫 皆
癤	病 節	疒 節
謯	言 虘	訁 虘
鶛	皆 鳥
卩	丨 乛
卪	卩 丶
孑	了 丿
尐	小 乀
节	竹 卩
讦	言 干	讠 干
刦	去 刀	去 刂
刧	去 刀
劫	去 力
岊	巴 山
昅	日 及
刼	去 刃
劼	吉 力
杰	木 火	木 灬
疌	一 聿 卜 人	一 肀 卜 人
拮	手 吉	扌 吉	才 吉
洁	水 吉	氵 吉
结	丝 吉	纟 吉
迼	辵 吉	辶 吉
倢	人 疌	亻 疌
桀	舛 木
莭	草 即	艸 即	艹 即
訐	言 干	訁 干
偼	人 疌	亻 疌
婕	女 疌
捷	手 疌	扌 疌	才 疌
袺	衣 吉	衤 吉
傑	人 桀	亻 桀
結	絲 吉	糹 吉	糸 吉
絜	丰 刀 糸
颉	吉 页
嵥	山 桀
楬	木 曷
楶	木 咨	次 呆
睫	目 疌
節	竹 艮 卩
蜐	虫 劫
蝍	虫 即
蝍	蟲 即	虫 即
詰	言 吉	訁 吉
魝	魚 刀	魚 刂
截	十 戈 隹	土 戈 隹	𢦏 隹
榤	木 桀
碣	石 曷
竭	立 曷
蓵	草 捷	艸 捷	艹 捷
鲒	鱼 吉
潔	水 絜	氵 絜
羯	羊 曷
踕	足 疌
鞊	革 吉
幯	巾 節
嶻	山 截
擮	手 截	扌 截	才 截
礍	石 葛
鍻	金 曷	釒 曷
鮚	魚 吉
巀	山 雀 戈
櫭	木 暨
蠘	虫 截
蠘	蟲 截	虫 截
蠽	雀 戈 虫 虫
蠽	雀 戈 蟲 蟲	雀 戈 虫 虫
姐	女 且
毑	母 也
媎	女 者
解	角 刀 牛
觧	角 羊
飷	食 且
檞	木 解
丯	丨 彡
介	人 丿 丨
吤	口 介
岕	山 介
庎	广 介
戒	廾 戈
芥	草 介	艸 介	艹 介
屆	尸 凵 士
届	尸 由
玠	玉 介	王 介
界	田 介
畍	田 介
疥	病 介	疒 介
砎	石 介
衸	衣 介	衤 介
诫	言 戒	讠 戒
借	人 昔	亻 昔
悈	心 戒	忄 戒
蚧	虫 介
蚧	蟲 介	虫 介
徣	彳 昔
堺	土 界
楐	木 界
琾	玉 界	王 界
蛶	虫 寽
蛶	蟲 寽	虫 寽
骱	骨 介
犗	牛 害	牜 害
誡	言 戒	訁 戒
褯	衣 席	衤 席
魪	魚 介
鎅	金 界	釒 界
巾	冂 丨
今	人 丶 乛
斤	厂 丅
钅	人 王	人 二 𠄌
兓	旡 旡
金	人 王 丷
釒	人 王 丷
津	水 聿	氵 聿
矜	矛 今
荕	草 肋	艸 肋	艹 肋
衿	衣 今	衤 今
觔	角 力
埐	土 彐 冖 又
珒	玉 聿	王 聿
矝	矛 令
紟	絲 今	糹 今	糸 今
惍	心 金	忄 金
堻	津 土
筋	竹 肉 力
筋	竹 肉 力	竹 月 力
釿	金 斤	釒 斤
嶜	山 旡 旡 日	山 朁
鹶	鹵 今
黅	黃 今
襟	衣 禁	衤 禁
仅	人 又	亻 又
尽	尺 冰	尺 冫
侭	人 尽	亻 尽
卺	丞 卩	丞 㔾
巹	丞 己
紧	丨 丨 又 丝
堇	廿 口 丰
菫	草 丅 口 三	艸 丅 口 三	艹 丅 口 三
僅	人 堇	亻 堇
厪	厂 堇
谨	言 堇	讠 堇
锦	金 帛	钅 帛
嫤	女 堇
廑	广 堇
漌	水 堇	氵 堇
盡	聿 火 皿	聿 灬 皿
緊	臤 絲	臤 糸
蓳	草 堇	艸 堇	艹 堇
馑	饣 堇
槿	木 堇
瑾	玉 堇	王 堇
儘	人 盡	亻 盡
錦	金 帛	釒 帛
謹	言 堇	訁 堇
饉	食 堇
伒	人 斤	亻 斤
劤	斤 力
劲	𢀖 力
妗	女 今
近	辵 斤	辶 斤
进	辵 井	辶 井
枃	木 勻
枃	木 匀
勁	巠 力
浕	水 尽	氵 尽
荩	草 尽	艸 尽	艹 尽
晉	一 厶 厶 一 日
晋	亚 日
浸	水 彐 冖 又	氵 彐 冖 又
烬	火 尽
赆	贝 尽
唫	口 金
琎	玉 进	王 进
祲	示 彐 冖 又	礻 彐 冖 又
進	辵 隹	辶 隹
煡	火 建
寖	宀 浸
搢	手 晉	扌 晉	才 晉
溍	水 晉	氵 晉
禁	林 示
缙	丝 晋	纟 晋
靳	革 斤
墐	土 堇
瑨	玉 晉	王 晉
僸	人 禁	亻 禁
凚	冰 禁	冫 禁
歏	堇 欠
殣	歹 堇
璡	玉 進	王 進
觐	堇 见
噤	口 禁
濅	水 宀 帚 又	氵 宀 帚 又
縉	絲 晉	糹 晉	糸 晉
賮	聿 火 貝	聿 灬 貝
嚍	口 盡
嬧	女 盡
濜	水 盡	氵 盡
藎	草 盡	艸 盡	艹 盡
燼	火 盡
璶	玉 盡	王 盡
覲	堇 見
贐	貝 盡
齽	齒 禁
坕	爪 土
坙	一 巛 土
巠	一 巛 工
京	亠 口 小
泾	水 𢀖	氵 𢀖
经	丝 𢀖	纟 𢀖
茎	草 𢀖	艸 𢀖	艹 𢀖
亰	亠 日 小
秔	禾 亢
荆	井 刀	井 刂
荊	草 开 刀	艸 开 刂	艹 开 刂
涇	水 巠	氵 巠
莖	草 巠	艸 巠	艹 巠
婛	女 京
惊	心 京	忄 京
旌	方 丿 一 生
旍	方 丿 一 令
猄	犬 京	犭 京
経	絲 圣	糹 圣	糸 圣
菁	草 青	艸 青	艹 青
晶	日 日 日
稉	禾 更
腈	肉 青	月 青
葏	草 津	艸 津	艹 津
睛	目 青
粳	米 更
經	絲 巠	糹 巠	糸 巠
兢	克 克
精	米 青
聙	耳 青
鲸	鱼 京
鵛	巠 鳥
鯨	魚 京
鶁	京 鳥
鶄	青 鳥
麖	鹿 京
鼱	鼠 青
驚	馬 敬
麠	鹿 畺
井	二 丿 丨
丼	井 丶
阱	阜 井	阝 井
刭	𢀖 刀	𢀖 刂
坓	井 土
宑	宀 井
汫	水 井	氵 井
汬	井 水
肼	肉 井	月 井
剄	巠 刀	巠 刂
穽	穴 井
颈	𢀖 页
景	日 京
儆	人 敬	亻 敬
頚	圣 頁
幜	巾 景
憬	心 景	忄 景
璄	玉 竟	王 竟
憼	敬 心
暻	日 景
璟	玉 景	王 景
璥	玉 敬	王 敬
頸	巠 頁
蟼	敬 虫
蟼	敬 蟲	敬 虫
警	敬 言
妌	女 井
净	冰 争	冫 争
弪	弓 𢀖
径	彳 𢀖
迳	辵 𢀖	辶 𢀖
俓	人 巠	亻 巠
婙	女 争
浄	水 争	氵 争
胫	肉 𢀖	月 𢀖
倞	人 京	亻 京
凈	冰 爭	冫 爭
弳	弓 巠
徑	彳 巠
痉	病 𢀖	疒 𢀖
竞	立 兄
逕	辵 巠	辶 巠
婧	女 青
桱	木 巠
梷	占 又 木
淨	水 爭	氵 爭
竫	立 爭
脛	肉 巠	月 巠
竟	立 日 儿
敬	茍 攴	茍 攵
痙	病 巠	疒 巠
竧	立 身
靓	青 见
傹	人 竟	亻 竟
靖	立 青
境	土 竟
獍	犬 竟	犭 竟
誩	言 言	訁 言
踁	足 巠
静	青 争
靚	青 見
曔	日 敬
镜	金 竟	钅 竟
靜	青 爭
瀞	水 静	氵 静
鏡	金 竟	釒 竟
競	竞 竞	立 兄 立 兄
竸	竟 竟	竝 覞
冂	丨 乙
冋	冂 口
坰	土 冋
扃	戶 冋
扃	户 冋
埛	土 冏
絅	絲 冋	糹 冋	糸 冋
駉	馬 冋
駫	馬 光
蘔	草 穎	艸 穎	艹 穎
冏	冂 八 口
囧	囗 儿 冂
泂	水 冋	氵 冋
炅	日 火
迥	辵 冋	辶 冋
侰	人 君	亻 君
炯	火 冋
逈	辵 向	辶 向
浻	水 冏	氵 冏
烱	火 冏
煚	昛 火
窘	穴 君
颎	匕 火 页
綗	絲 冏	糹 冏	糸 冏
僒	人 窘	亻 窘
煛	目 目 火
熲	匕 火 頁
澃	須 水
燛	臦 火
褧	耿 衣
勼	勹 九
纠	丝 丩	纟 丩
朻	木 丩
牞	牛 力	牜 力
究	穴 九
糺	絲 乚	糹 乚	糸 乚
鸠	九 鸟
糾	絲 丩	糹 丩	糸 丩
赳	走 丩
阄	门 龟
萛	草 目 廾	艸 目 廾	艹 目 廾
啾	口 秋
揂	手 酋	扌 酋	才 酋
揪	手 秋	扌 秋	才 秋
揫	秋 手
鳩	九 鳥
摎	手 翏	扌 翏	才 翏
樛	木 翏
鬏	髟 秋
鬮	鬥 龜
九	丿 乙
久	丿 入
乆	𠃊 人
乣	幺 乙	幺 乚
奺	女 久
灸	久 火
玖	玉 久	王 久
舏	舌 丩
韭	非 一
紤	絲 斤	糹 斤	糸 斤
酒	水 酉	氵 酉
镹	镸 久
镹	長 久	镸 久
韮	草 韭	艸 韭	艹 韭
匛	匚 久
旧	丨 日
臼	丿 丨 一 彐
咎	久 人 口	夂 人 口
疚	病 久	疒 久
柩	木 久
柾	木 正
倃	人 咎	亻 咎
捄	手 求	扌 求	才 求
桕	木 臼
匓	勹 艮 殳
厩	厂 既
救	求 攴	求 攵
就	京 尤
廄	广 艮 殳
廐	广 白 匕 旡
舅	臼 男
僦	人 就	亻 就
廏	广 白 匕 殳
慦	救 心
殧	歹 就
舊	草 隹 臼	艸 隹 臼	艹 隹 臼
鹫	就 鸟
匶	匚 舊
鯦	魚 咎
麔	鹿 咎
齨	齒 臼
鷲	就 鳥
凥	尸 几
抅	手 勾	扌 勾	才 勾
匊	勹 米
居	尸 古
拘	手 句	扌 句	才 句
泃	水 句	氵 句
狙	犬 且	犭 且
苴	草 且	艸 且	艹 且
驹	马 句
挶	手 局	扌 局	才 局
疽	病 且	疒 且
痀	病 句	疒 句
眗	目 句
砠	石 且
罝	网 且	罒 且
陱	阜 匊	阝 匊
娵	女 取
崌	山 居
掬	手 匊	扌 匊	才 匊	手 勹 米
梮	木 局
涺	水 居	氵 居
菹	草 沮	艸 沮	艹 沮
椐	木 居
琚	玉 居	王 居
腒	肉 居	月 居
趄	走 且
跔	足 句
锔	金 局	钅 局
裾	衣 居	衤 居
雎	且 隹
艍	舟 居
蜛	虫 居
蜛	蟲 居	虫 居
諊	言 匊	訁 匊
踘	足 匊
鋦	金 局	釒 局
駒	馬 句
鮈	魚 句
鴡	且 鳥
鞠	革 匊	革 勹 米
鞫	革 訇
鶋	居 鳥
局	尸 乛 口
泦	水 尻	氵 尻
侷	人 局	亻 局
狊	目 犬
桔	木 吉
毩	毛 米
婅	女 匊
淗	水 匊	氵 匊
焗	火 局
菊	草 匊	艸 匊	艹 匊	草 勹 米
郹	狊 邑	狊 阝
椈	木 匊
毱	毛 匊
湨	水 狊	氵 狊
犑	牛 狊	牜 狊
輂	共 車
僪	人 矞	亻 矞
粷	米 匊
跼	足 局
閰	門 臼
趜	走 匊
躹	身 匊
橘	木 矞
橘	木 矞	木 矛 冏
檋	木 輂
駶	馬 局
鵙	貝 鳥
蹫	足 矞
鵴	匊 鳥
巈	山 鞠
蘜	草 鞠	艸 鞠	艹 鞠
鶪	狊 鳥
鼰	鼠 貝
鼳	鼠 狊
驧	馬 鞠
咀	口 且
弆	去 廾
沮	水 且	氵 且
举	兴 二 丨
矩	矢 巨
莒	草 吕	艸 吕	艹 吕
莒	草 呂	艸 呂	艹 呂
挙	兴 手
椇	木 具
筥	竹 呂
榉	木 举
榘	矩 木
蒟	草 立 句	艸 立 句	艹 立 句
龃	齿 且
聥	耳 禹
舉	與 二 丨	臼 二 丨
踽	足 禹
擧	與 手
櫸	木 舉
齟	齒 且
欅	木 舉
巨	匚 乛 一	匚 乛 一
句	勹 口
讵	言 巨	讠 巨
姖	女 巨
岠	山 巨
怇	心 巨	忄 巨
拒	手 巨	扌 巨	才 巨
洰	水 巨	氵 巨
苣	草 巨	艸 巨	艹 巨
邭	句 邑	句 阝
具	目 一 八
怐	心 句	忄 句
怚	心 且	忄 且
拠	手 処	扌 処	才 処
昛	日 巨
歫	止 巨
炬	火 巨
秬	禾 巨
钜	金 巨	钅 巨
俱	人 具	亻 具
倨	人 居	亻 居
倶	人 具	亻 具
冣	冖 取
剧	居 刀	居 刂
粔	米 巨
耟	耒 巨
蚷	虫 巨
蚷	蟲 巨	虫 巨
袓	衣 且	衤 且
埧	土 具
埾	取 土
惧	心 具	忄 具
据	手 居	扌 居	才 居
詎	言 巨	訁 巨
距	足 巨
犋	牛 具	牜 具
跙	足 且
鉅	金 巨	釒 巨
飓	风 具
虡	虎 丱 一 八	虍 丱 一 八
豦	虎 豕	虍 豕
锯	金 居	钅 居
寠	宀 婁
愳	目 目 心
窭	穴 娄
聚	耳 又 乑
駏	馬 巨
劇	豦 刀	豦 刂
勮	豦 力
屦	尸 彳 娄	尸 彳 米 女
踞	足 居
鮔	魚 巨
壉	土 豦
懅	心 豦	忄 豦
據	手 豦	扌 豦	才 豦
澽	水 豦	氵 豦
窶	穴 婁
遽	辵 豦	辶 豦
鋸	金 居	釒 居
屨	尸 彳 婁
颶	風 具
貗	豸 婁
簴	竹 虡
躆	足 豦
醵	酉 豦
懼	心 瞿	忄 瞿
鐻	金 豦	釒 豦
姢	女 厶 肉	女 厶 月
娟	女 肙	女 口 月
捐	手 肙	扌 肙	才 肙	手 口 月
涓	水 肙	氵 肙
焆	火 肙
瓹	肙 瓦
脧	肉 夋	月 夋
裐	衣 肙	衤 肙
鹃	肙 鸟
勬	絭 力
镌	金 隽	钅 隽
鎸	金 隽	釒 隽
鵑	肙 鳥
鐫	金 雋	釒 雋
蠲	益 蜀
卷	丷 夫 卩	𠔉 㔾
卷	夫 八 卩	𠔉 㔾
呟	口 玄
帣	丷 夫 巾	𠔉 巾
埍	土 肙
捲	手 卷	扌 卷	才 卷
菤	草 卷	艸 卷	艹 卷
锩	金 卷	钅 卷
臇	肉 雋	月 雋
錈	金 卷	釒 卷
奆	大 巨
劵	丷 夫 力	𠔉 力
巻	丷 夫 己	𠔉 㔾
倦	人 卷	亻 卷
勌	卷 力
桊	丷 夫 木	𠔉 木
狷	犬 肙	犭 肙
绢	丝 肙	纟 肙	丝 口 月
隽	隹 乃
淃	水 卷	氵 卷
眷	丷 夫 目	𠔉 目
鄄	垔 邑	垔 阝
睊	目 肙
絭	丷 夫 糸	𠔉 糸
罥	网 肙	罒 肙
雋	隹 丨 乛 一 丨 乛
睠	目 卷
絹	絲 肙	糹 肙	糸 肙
飬	丷 夫 良
飬	丷 夫 良	𠔉 良
慻	心 丷 夫 目	忄 丷 夫 目	心 𠔉 目	忄 𠔉 目
蔨	草 圈	艸 圈	艹 圈
餋	丷 夫 食	𠔉 食
獧	犬 睘	犭 睘
縳	絲 專	糹 專	糸 專
羂	网 絹	罒 絹
噘	口 厥
撅	手 厥	扌 厥	才 厥
撧	手 絕	扌 絕	才 絕
屩	尸 彳 喬
蹻	足 喬
孒	了 一
孓	了 乀
决	冰 夬	冫 夬
刔	夬 刀	夬 刂
氒	氏 十
诀	言 夬	讠 夬
弡	弓 巨
抉	手 夬	扌 夬	才 夬
決	水 夬	氵 夬
芵	草 夬	艸 夬	艹 夬
泬	水 穴	氵 穴
玦	玉 夬	王 夬
玨	玉 王	王 王
挗	手 夷	扌 夷	才 夷
珏	玉 玉	王 玉
疦	病 夬	疒 夬
砄	石 夬
绝	丝 色	纟 色
虳	虫 勺
虳	蟲 勺	虫 勺
觉	小 冖 见
倔	人 屈	亻 屈
捔	手 角	扌 角	才 角
欮	屰 欠
蚗	虫 夬
蚗	蟲 夬	虫 夬
崛	山 屈
掘	手 屈	扌 屈	才 屈
斍	文 見
桷	木 角
殌	歹 巠
覐	見 爻
觖	角 夬
訣	言 夬	訁 夬
赽	走 夬
趹	足 夬
逫	辵 叕	辶 叕
傕	人 隺	亻 隺
厥	厂 欮
焳	火 隹
絕	絲 刀 巴	糹 刀 巴	糸 刀 巴	絲 色	糹 色	糸 色
絶	絲 色	糹 色	糸 色
覚	小 冖 見
趉	走 出
鈌	金 夬	釒 夬
劂	厥 刀	厥 刂
勪	喬 力
瑴	士 冖 一 王 殳
谲	言 矞	讠 矞
駃	馬 夬
嶥	山 厥
憰	心 矞	忄 矞
熦	火 雀
爴	國 爪
獗	犬 厥	犭 厥
瘚	病 欮	疒 欮
蕝	草 絕	艸 絕	艹 絕
蕨	草 厥	艸 厥	艹 厥
鴂	夬 鳥
鴃	鳥 夬
噱	口 豦
憠	厥 心
橛	木 厥
橜	厥 木
爵	爪 聿 爭 爭	爫 肀 爭
臄	肉 豦	月 豦
镢	金 厥	钅 厥
蟨	厥 虫
蟨	厥 蟲	厥 虫
蟩	虫 厥
蟩	蟲 厥	虫 厥
屫	尸 爿 喬
爑	火 蕉
譎	言 矞	訁 矞
蹶	足 厥
蹷	厥 足
鶌	屈 鳥
匷	匚 瞿
嚼	口 爵
矍	瞿 又	目 目 隻	目 目 隹 又
覺	臼 爻 冖 見	𦥯 見
鐍	金 矞	釒 矞
鐝	金 厥	釒 厥
灍	水 闕	氵 闕
爝	火 爵
觼	角 夐
彏	弓 矍
戄	心 矍	忄 矍
攫	手 瞿	扌 瞿	才 瞿
玃	犬 矍	犭 矍
鷢	厥 鳥
欔	木 矍
矡	矛 矍
龣	龠 录
貜	豸 矍
躩	足 矍
钁	金 矍	釒 矍
军	冖 车
君	尹 口
均	土 勻
均	土 匀
汮	水 勻	氵 勻
姰	女 旬
袀	衣 勻	衤 勻
軍	冖 車
钧	金 勻	钅 勻
莙	草 君	艸 君	艹 君
蚐	虫 勻
蚐	蟲 勻	虫 勻
桾	木 君
皲	军 皮
皲	皮 军
菌	草 囷	艸 囷	艹 囷
鈞	金 勻	釒 勻
碅	石 囷
皸	軍 皮
皹	皮 軍
覠	君 見
銁	金 旬	釒 旬
銞	旬 金
鲪	鱼 君
麇	鹿 禾
鍕	金 軍	釒 軍
鮶	魚 君
麏	鹿 君
麕	鹿 囷
呁	口 勻
俊	人 夋	亻 夋
郡	君 邑	君 阝
陖	阜 夋	阝 夋
埈	土 夋
峻	山 夋
捃	手 君	扌 君	才 君
浚	水 夋	氵 夋
馂	饣 夋
骏	马 夋
晙	日 夋
焌	火 夋
珺	玉 君	王 君
棞	木 囷	木 囗 禾
畯	田 夋
竣	立 夋
儁	人 雋	亻 雋
箘	竹 囷
箟	竹 昆
蜠	虫 囷
蜠	蟲 囷	虫 囷
寯	宀 雋
懏	心 雋	忄 雋
餕	食 夋
燇	火 尊
濬	水 睿	氵 睿
駿	馬 夋
鵔	鳥 夋
鵕	夋 鳥
鵘	君 鳥
攈	手 麇	扌 麇	才 麇
攟	手 麕	扌 麕	才 麕
咔	口 卡
咖	口 加
喀	口 客
衉	血 各
擖	手 葛	扌 葛	才 葛
卡	上 卜	上 下
佧	人 卡	亻 卡
胩	肉 卡	月 卡
鉲	金 卡	釒 卡
开	一 廾
奒	大 亥
揩	手 皆	扌 皆	才 皆
锎	金 开	钅 开
開	門 开
鐦	金 開	釒 開
凯	岂 几
剀	岂 刀	岂 刂
垲	土 岂
恺	心 岂	忄 岂
闿	门 岂
铠	金 岂	钅 岂
凱	豈 几
剴	豈 刀	豈 刂
嘅	口 既
慨	心 既	忄 既
蒈	草 皆	艸 皆	艹 皆
塏	土 豈
嵦	山 豈
愷	心 豈	忄 豈
楷	木 皆
輆	車 亥
暟	日 豈
锴	金 皆	钅 皆
鍇	金 皆	釒 皆
鎧	金 豈	釒 豈
闓	門 豈
颽	豈 風
忾	心 气	忄 气
炌	火 介
炏	火 火
欬	亥 欠
烗	火 亥
勓	皆 力
愒	心 曷	忄 曷
愾	心 氣	忄 氣
鎎	金 氣	釒 氣
刊	干 刀	干 刂
栞	干 干 木
勘	甚 力
龛	合 龙
堪	土 甚
嵁	山 甚
戡	甚 戈
龕	合 龍
冚	冖 山
坎	土 欠
侃	人 口 川	亻 口 川
砍	石 欠
莰	草 坎	艸 坎	艹 坎
偘	人 品	亻 品
埳	土 臽
惂	心 臽	忄 臽
欿	臽 欠
塪	土 舀
歁	甚 欠
槛	木 监
輡	車 臽
檻	木 監
顑	咸 頁
轗	車 感
看	手 目
衎	行 干	彳 干 亍
崁	山 坎
墈	土 勘
瞰	目 敢
磡	石 勘	石 甚 力
闞	門 敢
矙	目 闞
忼	心 亢	忄 亢
闶	门 亢
砊	石 亢
粇	米 亢
康	广 隶
嫝	女 康
慷	心 康	忄 康
漮	水 康	氵 康
槺	木 康
穅	禾 康
糠	米 康
躿	身 康
鏮	金 康	釒 康
鱇	魚 康
扛	手 工	扌 工	才 工
摃	手 貢	扌 貢	才 貢
亢	亠 几
伉	人 亢	亻 亢
匟	匚 亢
邟	亢 邑	亢 阝
囥	囗 亢
抗	手 亢	扌 亢	才 亢
犺	犬 亢	犭 亢
炕	火 亢
钪	金 亢	钅 亢
鈧	金 亢	釒 亢
閌	門 亢
尻	尸 九
髛	高 尻
丂	一 乛
丂	一 乙
攷	丂 攴	丂 攵
考	土 丿 丂	耂 丂	老 丂
拷	手 考	扌 考	才 考
洘	水 考	氵 考
栲	木 考
烤	火 考
铐	金 考	钅 考
犒	牛 高	牜 高
銬	金 考	釒 考
鲓	鱼 考
靠	告 非
鮳	魚 考
鯌	魚 告
匼	匚 合
苛	草 可	艸 可	艹 可
柯	木 可
牁	爿 可
珂	玉 可	王 可
科	禾 斗
胢	肉 可	月 可
轲	车 可
疴	病 可	疒 可
砢	石 可
趷	足 乞
钶	金 可	钅 可
棵	木 果
萪	草 科	艸 科	艹 科
軻	車 可
颏	亥 页
嗑	口 盍	口 去 皿
搕	手 盍	扌 盍	才 盍
犐	牛 科	牜 科
稞	禾 果
窠	穴 果
鈳	金 可	釒 可
榼	木 盍
薖	草 過	艸 過	艹 過
颗	果 页
樖	合 柯
瞌	目 盍	目 去 皿
磕	石 盍	石 去 皿
蝌	虫 科
蝌	蟲 科	虫 科
錒	金 阿	釒 阿
醘	酉 盍
顆	果 頁
髁	骨 果
礚	石 蓋
壳	士 冗
揢	手 客	扌 客	才 客
殼	壳 一 殳
翗	多 羽
可	一 口 亅	丁 口
坷	土 可
岢	山 可
炣	火 可
渇	水 日 勹 匕	氵 日 勹 匕
嵑	山 曷
敤	果 攴
渴	水 曷	氵 曷
嶱	山 葛
克	十 兄	十 口 儿
刻	亥 刀	亥 刂
勀	克 力
勊	克 力
客	宀 各
恪	心 各	忄 各
娔	女 克
尅	克 寸
课	言 果	讠 果
堁	土 果
氪	气 克
氪	氣 克	气 克
骒	马 果
缂	丝 革	纟 革
愙	客 心
溘	水 盍	氵 盍
锞	金 果	钅 果
碦	石 客
緙	絲 革	糹 革	糸 革
艐	舟 凶 八 夕	舟 凶 八 夂
課	言 果	訁 果
礊	車 凵 殳 石
騍	馬 果
剋	克 刀	克 刂
肎	冖 肉	冖 月
肯	止 肉	止 月
肻	卜 肎	卜 冖 肉	卜 冖 月
垦	艮 土
恳	艮 心
啃	口 肯
豤	豕 艮
龈	齿 艮
墾	豸 艮 土
錹	金 肯	釒 肯
懇	豸 艮 心
齦	齒 艮
掯	手 肯	扌 肯	才 肯
裉	衣 艮	衤 艮
褃	衣 肯	衤 肯
劥	亢 力
阬	阜 亢	阝 亢
吭	口 亢
坑	土 亢
妔	女 亢
挳	手 巠	扌 巠	才 巠
硁	石 𢀖
牼	牛 巠	牜 巠
硜	石 巠
铿	金 坚	钅 坚
硻	臤 石
摼	手 堅	扌 堅	才 堅
誙	言 巠	訁 巠
銵	金 身	釒 身
鍞	金 貞	釒 貞
鏗	金 堅	釒 堅
空	穴 工
倥	人 空	亻 空
埪	土 空
崆	山 空
悾	心 空	忄 空
涳	水 空	氵 空
硿	石 空
箜	竹 空
錓	金 羌	釒 羌
鵼	空 鳥
孔	子 乙
孔	子 乙	子 乚
恐	巩 心	工 凡 心
控	手 空	扌 空	才 空
鞚	革 空
抠	手 区	扌 区	才 区
芤	草 孔	艸 孔	艹 孔
眍	目 区
剾	區 刀	區 刂
彄	弓 區
摳	手 區	扌 區	才 區
瞘	目 區
口	丨 乛 一	冂 一
劶	后 力
叩	口 卩
扣	手 口	扌 口	才 口
敂	句 攴	句 攵
冦	冖 元 攴
宼	宀 元 女
寇	宀 元 攴
釦	金 口	钅 口
釦	金 口	釒 口
窛	穴 元 女
筘	竹 扣
滱	水 寇	氵 寇
蔲	草 寇	艸 寇	艹 寇
蔻	草 寇	艸 寇	艹 寇
瞉	士 冖 一 目 殳
簆	竹 寇
鷇	士 冖 一 鳥 殳
扝	手 亏	扌 亏	才 亏
刳	夸 刀	夸 刂
矻	石 乞
郀	夸 邑	夸 阝
枯	木 古
哭	口 口 犬
桍	木 夸
堀	土 屈
崫	山 屈
圐	囗 目 方	囗 网 方	囗 罒 方
跍	足 古
窟	穴 屈
骷	骨 古
鮬	魚 夸
狜	犬 古	犭 古
苦	草 古	艸 古	艹 古
库	广 车
俈	人 告	亻 告
绔	丝 夸	纟 夸
庫	广 車
秙	禾 古
趶	足 于
焅	火 告
袴	衣 夸	衤 夸
喾	小 冖 告
絝	絲 夸	糹 夸	糸 夸
裤	衣 库	衤 库
瘔	病 苦	疒 苦
酷	酉 告
褲	衣 庫	衤 庫
嚳	臼 爻 冖 告	𦥯 告
夸	大 亏
姱	女 夸
誇	言 夸	訁 夸
侉	人 夸	亻 夸
咵	口 夸
垮	土 夸
銙	金 夸	釒 夸
挎	手 夸	扌 夸	才 夸
胯	肉 夸	月 夸
跨	足 夸
骻	骨 夸
蒯	萠 刀	萠 刂
擓	手 匯	扌 匯	才 匯
凷	凵 土
块	土 夬
快	心 夬	忄 夬
侩	人 会	亻 会
郐	会 邑	会 阝
哙	口 会
狯	犬 会	犭 会
脍	肉 会	月 会
塊	土 鬼
筷	竹 快
鲙	鱼 会
儈	人 會	亻 會
墤	土 貴
鄶	會 邑	會 阝
噲	口 會
廥	广 會
獪	犬 會	犭 會
膾	肉 會	月 會
旝	方 丿 一 會
糩	米 會
鱠	魚 會
宽	宀 草 见	宀 艸 见	宀 艹 见
寛	宀 草 見	宀 艸 見	宀 艹 見
寬	宀 草 見 丶	宀 艸 見 丶	宀 艹 見 丶
臗	肉 寬	月 寬
髋	骨 宽
髖	骨 寬
欵	匕 矢 欠
款	士 示 欠
歀	柰 欠
窾	穴 款
匡	匚 王
劻	匡 力
诓	言 匡	讠 匡
邼	匡 邑	匡 阝
匩	匚 山 王	匡 山
哐	口 匡
恇	心 匡	忄 匡
洭	水 匡	氵 匡
框	木 匡
硄	石 光
筐	竹 匡
誆	言 匡	訁 匡
軭	車 匡
忹	心 王	忄 王
抂	手 王	扌 王	才 王
狂	犬 王	犭 王
狅	犬 壬	犭 壬
诳	言 狂	讠 狂
軖	車 王
軠	車 壬
誑	言 狂	訁 狂
鵟	狂 鳥
夼	大 川
儣	人 廣	亻 廣
懭	心 廣	忄 廣
卝	一 丨 丨 一
邝	广 邑	广 阝
圹	土 广
纩	丝 广	纟 广
况	冰 兄	冫 兄
旷	日 广
岲	山 兄
況	水 兄	氵 兄
矿	石 广
昿	日 広
贶	贝 兄
眖	目 兄
眶	目 匡
絖	絲 光	糹 光	糸 光
貺	貝 兄
軦	車 兄
鉱	金 広	釒 広
鋛	金 串	釒 串
鄺	廣 邑	廣 阝
壙	土 廣
黋	黄 光
黋	黃 光
懬	廣 心
曠	日 廣
爌	火 廣
矌	目 廣
礦	石 廣
穬	禾 廣
纊	絲 廣	糹 廣	糸 廣
鑛	金 廣	釒 廣
亏	一 丂	二 乛
刲	圭 刀	圭 刂
岿	山 归
悝	心 里	忄 里
盔	灰 皿
窥	穴 规
聧	耳 癸
窺	穴 規
虧	虎 隹 亏	虍 隹 亏
顝	骨 頁
闚	門 規
巋	山 歸
蘬	草 歸	艸 歸	艹 歸
奎	大 圭	大 土 土
晆	日 圭
逵	辵 坴	辶 坴
鄈	癸 邑	癸 阝
隗	阜 鬼	阝 鬼
頄	九 頁
馗	九 首
喹	口 奎
揆	手 癸	扌 癸	才 癸
葵	草 癸	艸 癸	艹 癸
骙	马 癸
戣	癸 戈
暌	日 癸
楏	木 奎
楑	木 癸
魁	鬼 斗
睽	目 癸
蝰	虫 奎
蝰	蟲 奎	虫 奎
頯	月 廾 頁
櫆	木 魁
藈	草 睽	艸 睽	艹 睽
鍨	金 癸	釒 癸
鍷	金 奎	釒 奎
騤	馬 癸
夔	丷 一 止 自 卩 夕	丷 一 止 自 卩 夂
蘷	草 夒	艸 夒	艹 夒
巙	山 夔
虁	草 卝 夒	艸 卝 夒	艹 卝 夒
犪	牛 夔	牜 夔
躨	足 夔
煃	火 奎
跬	足 圭
頍	支 頁
蹞	足 頃
尯	尢 危
匮	匚 贵
欳	卜 冊 欠
喟	口 胃
媿	女 鬼
愦	心 贵	忄 贵
愧	心 鬼	忄 鬼
溃	水 贵	氵 贵
腃	肉 卷	月 卷
蒉	草 贵	艸 贵	艹 贵
馈	食 贵	饣 贵
瞆	目 贵
嘳	口 貴
嬇	女 貴
憒	心 貴	忄 貴
潰	水 貴	氵 貴
篑	竹 贵
聩	耳 贵
聭	耳 鬼
蕢	草 貴	艸 貴	艹 貴
樻	木 貴
餽	食 鬼
簣	竹 貴
聵	耳 貴
籄	竹 貴
鐀	金 貴	釒 貴
饋	食 貴	飠 貴
鑎	金 匱	釒 匱
坤	土 申
昆	日 比
堃	方 方 土
婫	女 昆
崐	山 昆
崑	山 昆
晜	日 弟
猑	犬 昆	犭 昆
菎	草 昆	艸 昆	艹 昆
裈	衣 军	衤 军
焜	火 昆
琨	玉 昆	王 昆
髠	髟 几
裩	衣 昆	衤 昆
貇	豸 艮
锟	金 昆	钅 昆
髡	髟 兀
鹍	昆 鸟
蜫	虫 昆
蜫	蟲 昆	虫 昆
褌	衣 軍	衤 軍
髨	髟 元
瑻	玉 貫	王 貫
醌	酉 昆
錕	金 昆	釒 昆
鲲	鱼 昆
騉	馬 昆
鯤	魚 昆
鵾	昆 鳥
鶤	軍 鳥
悃	心 困	忄 困
捆	手 困	扌 困	才 困
阃	门 困
壸	士 冖 亚
梱	木 困
祵	示 困	礻 困
硱	石 困
稇	禾 困
裍	衣 困	衤 困
壼	士 冖 亞
稛	禾 困
綑	絲 困	糹 困	糸 困
閫	門 困
閸	門 亞
困	囗 木
涃	水 困	氵 困
睏	目 困
扩	手 广	扌 广	才 广
拡	手 広	扌 広	才 広
括	手 舌	扌 舌	才 舌
挄	手 光	扌 光	才 光
桰	木 氏 口
筈	竹 舌
萿	草 活	艸 活	艹 活
葀	草 括	艸 括	艹 括
蛞	虫 舌
蛞	蟲 舌	虫 舌
阔	门 活
廓	广 郭
頢	舌 頁
髺	髟 舌
擴	手 廣	扌 廣	才 廣
濶	水 門 舌	氵 門 舌
闊	門 活
鞟	革 享
懖	銛 心
霩	雨 郭
鞹	革 郭
鬠	髟 會
垃	土 立
拉	手 立	扌 立	才 立
柆	木 立
翋	羽 立
菈	草 拉	艸 拉	艹 拉
搚	手 脅	扌 脅	才 脅
邋	辵 巤	辶 巤
旯	日 九
剌	束 刀	束 刂
砬	石 立
揦	手 剌	扌 剌	才 剌
磖	石 習
嚹	口 罅
喇	口 剌
藞	草 磊	艸 磊	艹 磊
腊	肉 昔	月 昔
揧	剌 手
楋	木 剌
瘌	病 剌	疒 剌
蜡	虫 昔
蝋	蟲 鼡	虫 鼡
辢	束 辛
辣	辛 束
蝲	虫 剌
蝲	蟲 剌	虫 剌
臈	肉 葛	月 葛
攋	手 賴	扌 賴	才 賴
爉	火 巤
臘	肉 巤	月 巤
鬎	髟 剌
瓎	玉 賴	王 賴
镴	金 巤	钅 巤
鯻	魚 剌
蠟	蟲 巤	虫 巤
鑞	金 巤	釒 巤
啦	口 拉
鞡	革 拉
来	一 米
來	木 人 人	一 人 人 丨 人
俫	人 来	亻 来
倈	人 來	亻 來
崃	山 来
徕	彳 来
涞	水 来	氵 来
莱	草 来	艸 来	艹 来
郲	來 邑	來 阝
婡	女 來
崍	山 來
庲	广 來
徠	彳 來
梾	木 来
淶	水 來	氵 來
猍	犬 來	犭 來
萊	草 來	艸 來	艹 來
逨	辵 來	辶 來
棶	木 來
琜	玉 來	王 來
筙	竹 耒
铼	金 来	钅 来
箂	竹 來
錸	金 來	釒 來
騋	馬 來
鯠	魚 來
鶆	來 鳥
麳	麥 來
唻	口 來
赉	来 贝
睐	目 来
睞	目 來
赖	束 负
賚	來 貝
濑	水 赖	氵 赖
賴	束 負
頼	束 頁
顂	來 頁
癞	病 赖	疒 赖
鵣	束 鳥
瀨	水 賴	氵 賴
瀬	水 頼	氵 頼
籁	竹 赖
藾	草 賴	艸 賴	艹 賴
櫴	木 賴
癩	病 賴	疒 賴
襰	衣 賴	衤 賴
籟	竹 賴
兰	丷 三
岚	山 风
拦	手 兰	扌 兰	才 兰
栏	木 兰
婪	林 女	木 木 女
惏	心 林	忄 林
嵐	山 風
葻	草 風	艸 風	艹 風
阑	门 柬
蓝	草 监	艸 监	艹 监
谰	言 阑	讠 阑
厱	厂 僉
澜	水 阑	氵 阑
褴	衣 监	衤 监
儖	人 監	亻 監
斓	文 阑
篮	竹 监
懢	心 監	忄 監
燣	火 稟
燷	火 禀
藍	草 監	艸 監	艹 監
襕	衣 阑	衤 阑
镧	金 阑	钅 阑
闌	門 柬
璼	玉 監	王 監
襤	衣 監	衤 監
譋	言 閒	訁 閒
幱	巾 闌
攔	手 闌	扌 闌	才 闌
瀾	水 闌	氵 闌
灆	水 藍	氵 藍
籃	竹 監
繿	絲 監	糹 監	糸 監
蘭	草 闌	艸 闌	艹 闌
斕	文 闌
欄	木 闌
礷	石 藍
襴	衣 闌	衤 闌
囒	口 蘭
灡	水 蘭	氵 蘭
籣	竹 闌
讕	言 闌	訁 闌
躝	足 闌
钄	金 蘭	釒 蘭
韊	革 蘭
览	丨 丨 丿 一 丶 见
浨	水 宋	氵 宋
揽	手 览	扌 览	才 览
缆	丝 览	纟 览
榄	木 览
漤	水 婪	氵 婪
罱	网 南	罒 南
醂	酉 林
壈	土 稟
懒	心 赖	忄 赖
覧	臣 丿 一 丶 見	臣 丿 一 丶 見
擥	臣 丿 一 丶 网 手	臣 丿 一 丶 罒 手
嬾	女 賴
懶	心 賴	忄 賴
孄	女 闌
覽	臣 丿 一 丶 网 見	臣 丿 一 丶 罒 見
孏	女 蘭
攬	手 覽	扌 覽	才 覽
灠	水 覽	氵 覽
欖	木 覽
顲	炎 亠 回 頁
纜	絲 覽	糹 覽	糸 覽
烂	火 兰
滥	水 监	氵 监
燗	火 閒
嚂	口 監
濫	水 監	氵 監
爁	火 監
爛	火 闌
瓓	玉 闌	王 闌
爤	火 蘭
鑭	金 闌	釒 闌
糷	米 蘭
啷	口 郎
勆	良 力
郎	良 邑	良 阝
郞	良 邑	良 阝
欴	良 欠
狼	犬 良	犭 良
阆	门 良
嫏	女 郎
廊	广 郎
桹	木 良
琅	玉 良	王 良
蓈	草 郎	艸 郎	艹 郎
榔	木 郎
瑯	玉 郎	王 郎
硠	石 良
稂	禾 良
锒	金 良	钅 良
筤	竹 良
艆	舟 良
蜋	虫 良
蜋	蟲 良	虫 良
螂	虫 郎
螂	蟲 郎	虫 郎
躴	身 良
鋃	金 良	釒 良
鎯	金 郎	釒 郎
駺	馬 良
朗	良 月
朖	月 良
烺	火 良
塱	朗 土
蓢	草 朗	艸 朗	艹 朗
樃	木 朗
誏	言 良	訁 良
朤	月 月 月 月
埌	土 良
崀	山 良
浪	水 良	氵 良
莨	草 良	艸 良	艹 良
蒗	草 浪	艸 浪	艹 浪
閬	門 良
唥	口 冷
捞	手 劳	扌 劳	才 劳
撈	手 勞	扌 勞	才 勞
劳	草 冖 力	艸 冖 力	艹 冖 力
劳	草 冖 力	艹 冖 力
労	小 冖 力	丶 丶 丿 冖 力	八 宀 力
牢	宀 牛
窂	穴 牛
哰	口 牢
唠	口 劳
崂	山 劳
浶	水 牢	氵 牢
勞	𤇾 力	𤇾 力	火 火 冖 力
痨	病 劳	疒 劳
铹	金 劳	钅 劳
僗	人 勞	亻 勞
嘮	口 勞
嶗	山 勞
憥	勞 心
癆	病 勞	疒 勞
磱	石 勞
簩	竹 勞
蟧	蟲 勞	虫 勞
醪	酉 翏
鐒	金 勞	釒 勞
顟	翏 頁
髝	高 勞
耂	土 丿
老	土 丿 匕	耂 匕
佬	人 老	亻 老
咾	口 老
姥	女 老
恅	心 老	忄 老
狫	犬 老	犭 老
荖	草 老	艸 老	艹 老
栳	木 老
铑	金 老	钅 老
銠	金 老	釒 老
潦	水 尞	氵 尞
橑	木 尞
轑	車 尞
涝	水 劳	氵 劳
烙	火 各
嗠	孚 各
耢	耒 劳
酪	各 酉
酪	酉 各
嫪	女 翏
憦	心 勞	忄 勞
澇	水 勞	氵 勞
橯	木 勞
耮	耒 勞
軂	身 勞
肋	肉 力	月 力
仂	人 力	亻 力
阞	阜 力	阝 力
乐	丿 丨 木	匚 小
乐	丿 丨 木	丿 丨 朩
叻	口 力
忇	心 力	忄 力
扐	手 力	扌 力	才 力
氻	水 力	氵 力
艻	草 力	艸 力	艹 力
玏	玉 力	王 力
泐	水 阞	氵 阞
竻	竹 力
砳	石 石
楽	冰 白 丶 丶 木	冫 白 丶 丶 木
韷	音 出
樂	幺 白 幺 木
簕	竹 勒
鳓	鱼 勒
鰳	魚 勒
了	乛 亅
饹	食 各	饣 各
餎	食 各	飠 各
勒	革 力
雷	雨 田
嫘	女 累
缧	丝 累	纟 累
蔂	草 累	艸 累	艹 累
畾	田 田 田
擂	手 雷	扌 雷	才 雷
檑	木 雷
縲	絲 累	糹 累	糸 累
礌	石 雷
镭	金 雷	钅 雷
櫑	木 畾
瓃	玉 畾	王 畾
羸	亡 口 月 羊 凡
礧	石 畾
纍	畾 糸
罍	畾 缶
蘲	草 壘	艸 壘	艹 壘
鐳	金 雷	釒 雷
轠	車 畾
儽	人 纍	亻 纍
壨	田 田 田 田 土
鑘	金 畾	釒 畾
靁	雨 畾
虆	草 纍	艸 纍	艹 纍
欙	木 纍
纝	絲 纍	糹 纍	糸 纍
鼺	鼠 畾
鼺	鼠 畾	鼠 田 田 田
厽	厶 厶 厶
耒	二 木	一 未	末 一	丰 八	三 小
诔	言 耒	讠 耒
垒	厽 土	厶 厶 厶 土
絫	厽 糸
腂	肉 果	月 果
傫	人 累	亻 累
誄	言 耒	訁 耒
樏	木 累
磊	石 石 石
蕌	草 畾	艸 畾	艹 畾
磥	石 累
蕾	草 雷	艸 雷	艹 雷
儡	人 畾	亻 畾	人 田 田 田	亻 田 田 田
壘	畾 土	田 田 田 土
癗	病 雷	疒 雷
藟	草 畾	艸 畾	艹 畾
櫐	畾 木
矋	目 厲
礨	畾 石
灅	水 壘	氵 壘
蠝	虫 畾
蠝	蟲 畾	虫 畾
蘽	草 櫐	艸 櫐	艹 櫐
讄	言 畾	訁 畾
鑸	金 壘	釒 壘
鸓	畾 鳥
泪	水 目	氵 目
洡	水 耒	氵 耒
类	米 大
涙	水 戻	氵 戻
淚	水 戾	氵 戾
累	田 糸	田 丝
累	田 絲	田 糸
酹	酉 寽
銇	金 耒	釒 耒
頛	耒 頁
頪	米 頁
錑	金 戾	釒 戾
攂	手 畾	扌 畾	才 畾
颣	米 糸 页
類	类 頁
纇	米 糸 頁
蘱	草 類	艸 類	艹 類
禷	示 類	礻 類
嘞	口 勒
崚	山 夌
塄	土 目 方	土 罒 方
棱	木 夌
楞	木 网 方	木 罒 方
碐	石 夌
稜	禾 夌
輘	車 夌
薐	草 稜	艸 稜	艹 稜
冷	冰 令	冫 令
倰	人 夌	亻 夌
堎	土 夌
愣	心 网 方	忄 罒 方
睖	目 夌
踜	足 夌
哩	口 里
刕	刀 刀 刀
杝	木 也
厘	厂 里
剓	禾 勹 丿 刀
狸	犬 里
狸	犬 里	犭 里
离	亠 凵 乂 冂 厶
荲	草 里	艸 里	艹 里
骊	马 丽
悡	利 心
梨	利 木
梩	木 里
梸	木 利
犁	利 牛
琍	玉 利	王 利
菞	草 禾 勹 丿	艸 禾 勹 丿	艹 禾 勹 丿
喱	口 厘
棃	禾 勹 丿 木
犂	禾 丿 刀 牛
鹂	丽 鸟
剺	未 攵 厂 刀
漓	水 离	氵 离
筣	竹 利
缡	丝 离	纟 离
艃	舟 里
蓠	草 离	艸 离	艹 离
蜊	虫 利
蜊	蟲 利	虫 利
嫠	未 攵 厂 女
孷	未 攵 厂 子
樆	木 离
璃	玉 离	王 离
盠	彖 皿
竰	立 厘
貍	豸 里	犭 里 狸
糎	米 厘
蔾	菞 木
褵	衣 离	衤 离
鋫	利 金
鲡	鱼 丽
黎	黍 勹 丿	禾 勹 丿 人 水
篱	竹 离
縭	絲 离	糹 离	糸 离
罹	网 心 隹	罒 忄 隹	罓 忄 隹
錅	禾 勹 丿 金
蟍	虫 梨
蟍	蟲 梨	虫 梨
謧	言 离	訁 离
醨	酉 离
嚟	口 黎
藜	草 黎	艸 黎	艹 黎
邌	辵 黎	辶 黎
離	离 隹
斄	未 攵 厂 來
瓈	玉 黎	王 黎
鏫	金 梨	釒 梨
鯬	禾 勹 丿 魚
鵹	禾 勹 丿 鳥
黧	禾 勹 丿 黑
囄	口 離
灕	水 離	氵 離
蘺	草 離	艸 離	艹 離
蠡	彖 虫 虫
蠡	彖 蟲 蟲	彖 虫 虫
蠫	豸 刀 虫 虫	豸 刂 虫 虫
蠫	豸 刀 蟲 蟲	豸 刂 虫 虫
孋	女 麗
廲	广 麗
劙	蠡 刀	蠡 刂
鑗	金 黎	釒 黎
穲	禾 麗
籬	竹 離
纚	絲 麗	糹 麗	糸 麗
驪	馬 麗
鱺	魚 麗
鸝	麗 鳥
礼	示 乚	礻 乚
李	木 子
里	甲 二	田 土
里	甲 二	田 土	曰 土
俚	人 里	亻 里
峛	山 列
峢	山 列
娌	女 里
峲	山 利
浬	水 里	氵 里
逦	辵 丽	辶 丽
理	玉 里	王 里
裡	衣 里	衤 里
锂	金 里	钅 里
粴	米 里
裏	衣 里
豊	曲 豆
鋰	金 里	釒 里
鲤	鱼 里
兣	克 厘
澧	水 豊	氵 豊
禮	示 豊	礻 豊
鯉	魚 里
蟸	豕 虫 虫
蟸	豕 蟲 蟲	豕 虫 虫
醴	酉 豊
鳢	鱼 豊
邐	辵 麗	辶 麗
鱧	魚 豊
欚	木 蠡
力	丿 乛
历	厂 力
厉	厂 万
屴	山 力
立	亠 丷 一
吏	一 口 乂	一 口 丿 乀
朸	木 力
丽	一 冂 丶 冂 丶
利	禾 刀	禾 刂
励	厉 力
呖	口 历
坜	土 历
沥	水 历	氵 历
苈	草 历	艸 历	艹 历
例	人 列	亻 列
岦	山 立
戾	户 大
枥	木 历
沴	水 人 彡	氵 人 彡
疠	病 万	疒 万
苙	草 立	艸 立	艹 立
隶	彐 水
俐	人 利	亻 利
俪	人 丽	亻 丽
栃	木 厉
栎	木 乐
疬	病 历	疒 历
砅	石 水
茘	草 刕	艸 刕	艹 刕
荔	草 劦	艸 劦	艹 劦
赲	走 力
轹	车 乐
郦	丽 邑	丽 阝
唎	口 利
悧	心 利	忄 利
栗	西 木
栗	西 木	襾 木	覀 木
栛	木 劦
涖	水 位	氵 位
猁	犬 利	犭 利
珕	玉 劦	王 劦
砺	石 厉
砾	石 乐
秝	禾 禾
莅	草 位	艸 位	艹 位
莉	草 利	艸 利	艹 利
唳	口 戻
婯	丽 女
悷	心 戾	忄 戾
笠	竹 立
粒	米 立
粝	米 厉
脷	肉 利	月 利
蚸	虫 斥
蚸	蟲 斥	虫 斥
蛎	虫 厉
傈	人 栗	亻 栗
凓	冰 栗	冫 栗
厤	厂 秝
棙	木 戾
痢	病 利	疒 利
蛠	虫 劦
蛠	蟲 劦	虫 劦
詈	目 言	罒 言
跞	足 乐
雳	雨 历
厯	厂 林 乚 丶 丶
塛	土 栗
慄	心 栗	忄 栗
搮	手 栗	扌 栗	才 栗
溧	水 栗	氵 栗
蒚	草 鬲	艸 鬲	艹 鬲
蒞	草 水 位	艸 氵 位	艹 氵 位
鉝	金 立	釒 立
鳨	鳥 力
厲	厂 萬
暦	厂 林 日
歴	厂 林 止
瑮	玉 栗	王 栗
綟	絲 戻	糹 戻	糸 戻
蜧	虫 戾
蜧	蟲 戾	虫 戾
蝷	虫 广 屰
蝷	蟲 广 屰	虫 广 屰
勵	厲 力
曆	厂 禾 禾 日	厂 秝 日
歷	厂 禾 禾 止	厂 秝 止
篥	竹 栗
鴗	立 鳥
巁	山 厲
濿	水 厲	氵 厲
癘	病 萬	疒 萬
磿	厤 石
隸	木 示 隶
鬁	髟 利
儮	人 歷	亻 歷
曞	日 厲
櫔	木 厲
爄	火 厲
犡	牛 厲	牜 厲
禲	示 厲	礻 厲
蠇	蟲 萬	虫 萬
鎘	金 鬲	釒 鬲
嚦	口 歷
壢	土 歷
攊	手 歷	扌 歷	才 歷
櫟	木 樂
瀝	水 歷	氵 歷
瓅	玉 樂	王 樂
礪	石 厲
藶	草 歷	艸 歷	艹 歷
麗	丽 鹿
櫪	木 歷
爏	火 歷
瓑	玉 歷	王 歷
皪	白 樂
盭	幺 幸 攴 皿	幺 幸 攵 皿
礫	石 樂
糲	米 厲
蠣	蟲 厲	虫 厲
儷	人 麗	亻 麗
癧	病 歷	疒 歷
礰	石 歷
酈	麗 邑	麗 阝
鷅	栗 鳥
麜	鹿 栗
囇	口 麗
攦	手 麗	扌 麗	才 麗
觻	角 樂
躒	足 樂
轢	車 樂
欐	木 麗
讈	言 歷	訁 歷
轣	車 歷
攭	手 蠡	扌 蠡	才 蠡
瓥	瓜 豕 虫 虫
瓥	瓜 豕 蟲 蟲	瓜 豕 虫 虫
靂	雨 歷
鱱	魚 厲
鱳	魚 樂
靋	雨 瀝
俩	人 两	亻 两
倆	人 兩	亻 兩
奁	大 区
连	辵 车	辶 车
帘	奴 巾
帘	穴 巾
怜	心 令	忄 令
涟	水 连	氵 连
莲	草 连	艸 连	艹 连
連	辵 車	辶 車
梿	木 连
联	耳 关
裢	衣 连	衤 连
亷	亠 兼 丿
嗹	口 連
廉	广 兼
慩	心 連	忄 連
溓	水 兼	氵 兼
漣	水 連	氵 連
蓮	草 連	艸 連	艹 連
匲	匚 大 品
奩	大 區
槤	木 連
熑	火 兼
覝	干 火 見
劆	廉 刀	廉 刂
匳	匚 僉
噒	口 粦
嫾	女 粦
憐	心 粦	忄 粦
磏	石 兼
聫	耳 幺 幺 大
褳	衣 連	衤 連
鲢	鱼 连
濂	水 廉	氵 廉
濓	水 亷	氵 亷
縺	絲 連	糹 連	糸 連
翴	羽 連
聮	耳 幺 幺 火	耳 幺 幺 灬
薕	草 廉	艸 廉	艹 廉
螊	虫 兼
螊	蟲 兼	虫 兼
櫣	木 連
燫	火 廉
聯	耳 幺 幺 丱	耳 幺 幺 卯
臁	肉 廉	月 廉
謰	言 連	訁 連
蹥	足 連
鎌	金 廉	釒 廉
镰	金 廉	钅 廉
簾	竹 廉
蠊	虫 廉
蠊	蟲 廉	虫 廉
鬑	髟 廉
鐮	金 廉	釒 廉
鰱	魚 連
籢	竹 斂
籨	竹 歛
敛	佥 攴	佥 攵
琏	玉 连	王 连
脸	肉 佥	月 佥
裣	衣 佥	衤 佥
摙	手 連	扌 連	才 連
璉	玉 連	王 連
蔹	草 敛	艸 敛	艹 敛
嬚	女 廉
斂	僉 攴	僉 攵
臉	肉 僉	月 僉
鄻	輦 邑	輦 阝
襝	衣 僉	衤 僉
羷	羊 僉
蘝	草 歛	艸 歛	艹 歛
蘞	草 斂	艸 斂	艹 斂
练	丝 东 一	纟 东 一
炼	火 东 一
恋	亦 心
浰	水 利	氵 利
殓	歹 佥
僆	人 連	亻 連
堜	土 柬
媡	女 柬
湅	水 柬	氵 柬
萰	草 柬	艸 柬	艹 柬
链	金 连	钅 连
楝	木 柬
煉	火 柬
瑓	玉 柬	王 柬
潋	水 敛	氵 敛
練	絲 柬	糹 柬	糸 柬
澰	水 僉	氵 僉
錬	金 東	釒 東
殮	歹 僉
鍊	金 柬	釒 柬
鏈	金 連	釒 連
瀲	水 斂	氵 斂
鰊	魚 柬
戀	絲 言 心	糸 言 糸 心	䜌 心
纞	絲 戀	糹 戀	糸 戀
良	丶 艮
俍	人 良	亻 良
凉	冰 京	冫 京
梁	水 刅 木	氵 刅 木
涼	水 京	氵 京
椋	木 京
辌	车 京
粮	米 良
粱	水 刀 八 米	氵 刀 八 米
墚	土 梁
綡	絲 京	糹 京	糸 京
踉	足 良
樑	木 梁
輬	車 京
糧	米 量
両	一 山 冂
两	一 冂 人 人	一 冂 从
兩	一 冂 丨 入 入
唡	口 两
啢	口 兩
掚	手 兩	扌 兩	才 兩
脼	肉 兩	月 兩
裲	衣 兩	衤 兩
緉	絲 兩	糹 兩	糸 兩
蜽	蟲 兩	虫 兩
魉	鬼 两
魎	鬼 兩
亮	亠 口 冖 儿
哴	口 良
悢	心 良	忄 良
谅	言 京	讠 京
辆	车 两
喨	口 亮
晾	日 京
湸	水 亮	氵 亮
量	日 一 里	曰 一 里
輌	車 両
諒	言 京	訁 京
輛	車 兩
鍄	金 京	釒 京
撩	手 尞	扌 尞	才 尞
蹽	足 尞
辽	辵 了	辶 了
疗	病 了	疒 了
聊	耳 卯
僚	人 尞	亻 尞
寥	宀 翏
嵺	山 翏
憀	心 翏	忄 翏
漻	水 翏	氵 翏
膋	火 火 冖 肉	火 火 冖 月	𤇾 肉	𤇾 月
嘹	口 尞
嫽	女 尞
寮	宀 尞
嶚	山 尞
嶛	山 尞
敹	卜 冖 一 米 攴	卜 冖 一 米 攵
獠	犬 尞	犭 尞
缭	丝 尞	纟 尞
遼	辵 尞	辶 尞
暸	日 尞
燎	火 尞
璙	玉 尞	王 尞
膫	肉 尞	月 尞
療	病 尞	疒 尞
竂	穴 尞
鹩	尞 鸟
屪	尸 尞
廫	广 膠
簝	竹 尞
繚	絲 尞	糹 尞	糸 尞
蟟	虫 尞
蟟	蟲 尞	虫 尞
豂	谷 翏
賿	貝 翏
蹘	足 翏
鐐	金 尞	釒 尞 镣
髎	骨 翏
飉	風 尞
鷯	尞 鳥
钌	金 了	钅 了
釕	金 了	釒 了
鄝	翏 邑	翏 阝
蓼	草 翏	艸 翏	艹 翏
憭	心 尞	忄 尞
镽	镸 尞
镽	長 尞	镸 尞
爒	炙 尞
尥	尢 勺
尦	尣 勺
炓	火 斗
料	米 斗
尞	昚 小
廖	广 翏
撂	手 畧	扌 畧	才 畧	手 田 各
窷	穴 聊
瞭	目 尞
镣	金 尞	钅 尞 鐐
咧	口 列
列	歹 刀	歹 刂
劣	少 力
冽	冰 列	冫 列
劽	列 力
姴	列 女
挒	手 列	扌 列	才 列
洌	水 列	氵 列
茢	草 列	艸 列	艹 列
迾	辵 列	辶 列
哷	口 寽
埒	土 寽
埓	土 寽
栵	木 列
浖	水 寽	氵 寽
烈	列 火	列 灬
捩	手 戾	扌 戾	才 戾	手 戶 犬	手 户 犬
猎	犬 昔	犭 昔
脟	肉 寽	月 寽
蛚	虫 列
蛚	蟲 列	虫 列
裂	列 衣
煭	巛 列 火	巛 列 灬
睙	目 戾
聗	耳 夾
趔	走 列
巤	巛 囗 乂 𠄌 丶 丶 𠄌 丶 丶 乀
颲	風 列
儠	人 巤	亻 巤
鮤	列 魚
鴷	列 鳥
擸	手 巤	扌 巤	才 巤
獵	犬 巤	犭 巤
犣	牛 巤	牜 巤
躐	足 巤
鬛	髟 囗 乂 𠄌 丶 丶 𠄌 丶 丶 乀
鬣	髟 巤
鱲	魚 巤
拎	手 令	扌 令	才 令
厸	厶 厶
邻	令 邑	令 阝
林	木 木
临	丨 丨 丿 一 丶 口 丨
冧	冖 林
啉	口 林
淋	水 林	氵 林
晽	日 林
琳	玉 林	王 林
粦	米 舛
粦	米 夕 十 𠃋
痳	病 林	疒 林
碄	石 林
箖	竹 林
粼	粦 巜
鄰	粦 邑	粦 阝
隣	阜 粦	阝 粦
嶙	山 粦
潾	水 粦	氵 粦
獜	犬 粦	犭 粦
遴	辵 粦	辶 粦
斴	粦 斤
暽	日 粦
燐	火 粦
璘	玉 粦	王 粦
辚	车 粦
霖	雨 林
瞵	目 粦
磷	石 粦
臨	臣 丿 一 品
繗	絲 粦	糹 粦	糸 粦
翷	粦 羽
麐	鹿 吝
轔	車 粦
壣	土 聯
瀶	水 臨	氵 臨
鏻	金 粦	釒 粦
鳞	鱼 粦
驎	馬 粦
鱗	魚 粦
麟	鹿 粦
菻	草 林	艸 林	艹 林
亃	粦 乙	粦 乚
凛	冰 禀	冫 禀
凜	冰 稟	冫 稟
撛	手 粦	扌 粦	才 粦
廩	广 稟
廪	广 禀
懍	心 稟	忄 稟
懔	心 禀	忄 禀
澟	水 稟	氵 稟
檁	木 稟
檩	木 禀
癛	病 稟	疒 稟
癝	病 禀	疒 禀
吝	文 口
恡	心 乂 厷	忄 乂 厷
悋	心 吝	忄 吝
赁	任 贝
焛	門 火
賃	任 貝
僯	人 粦	亻 粦
蔺	草 门 隹	艸 门 隹	艹 门 隹
橉	木 粦
甐	粦 瓦
膦	肉 粦	月 粦
閵	門 隹
疄	田 粦
藺	草 閵	艸 閵	艹 閵
蹸	足 粦
躏	足 蔺
躙	足 閵
躪	足 藺
轥	車 藺
〇	零	乛
伶	人 令	亻 令
刢	令 刀	令 刂
灵	彐 火
囹	囗 令
坽	土 令
夌	土 八 夂
姈	女 令
岺	山 令
彾	彳 令
泠	水 令	氵 令
狑	犬 令	犭 令
苓	草 令	艸 令	艹 令
昤	日 令
朎	月 令
柃	木 令
玲	玉 令	王 令
瓴	令 瓦
凌	冰 夌	冫 夌
皊	白 令
砱	石 令
秢	禾 令
竛	立 令
铃	金 令	钅 令
陵	阜 夌	阝 夌
鸰	令 鸟
婈	女 夌
掕	手 夌	扌 夌	才 夌
棂	木 灵
淩	水 夌	氵 夌
琌	玉 岑	王 岑
笭	竹 令
紷	絲 令	糹 令	糸 令
绫	丝 夌	纟 夌
羚	羊 令
翎	令 羽
聆	耳 令
舲	舟 令
菱	草 夌	艸 夌	艹 夌
蛉	虫 令
蛉	蟲 令	虫 令
衑	行 令	彳 令 亍
祾	示 夌	礻 夌
詅	言 令	訁 令
跉	足 令
軨	車 令
裬	衣 夌	衤 夌
鈴	金 令	釒 令
閝	門 令
零	雨 令
龄	齿 令
綾	絲 夌	糹 夌	糸 夌
蔆	草 淩	艸 淩	艹 淩
霊	雨 一 亚
駖	馬 令
澪	水 零	氵 零
蕶	草 零	艸 零	艹 零
錂	金 夌	釒 夌
魿	魚 令
鲮	鱼 夌
鴒	令 鳥
鹷	鹵 令
燯	火 零
霛	雨 弓 弓 弓
霝	雨 口 口 口
齢	歯 令
酃	霝 邑	霝 阝
鯪	魚 夌
孁	霝 女
蘦	草 霝	艸 霝	艹 霝
齡	齒 令
櫺	木 霝
醽	酉 霝
靈	霝 巫
欞	木 靈
爧	火 靈
麢	鹿 霝
龗	霝 龍
阾	阜 令	阝 令
岭	山 令
袊	衣 令	衤 令
领	令 页
領	令 頁
嶺	山 領
令	人 一 卩
令	人 丶 龴
另	口 力
呤	口 令
炩	火 令
溜	水 留	氵 留
熘	火 留
蹓	足 留
刘	文 刀	文 刂
沠	水 爪	氵 爪
畄	小 田
浏	水 文 刀	氵 文 刂
流	水 亠 厶 川	氵 亠 厶 川	氵 巟	水 㐬	氵 㐬
留	卯 田
旈	方 亠 厶 川	方 巟	方 㐬
琉	玉 亠 厶 川	王 亠 厶 川	王 巟	玉 㐬	王 㐬
畱	丣 田
硫	石 亠 厶 川	石 巟	石 㐬
裗	衣 亠 厶 川	衤 亠 厶 川	衣 巟	衤 巟	衣 㐬
裗	衣 亠 厶 川	衤 亠 厶 川	衣 巟	衤 巟	衣 㐬	衤 㐬
媹	女 留
嵧	山 留
旒	方 丿 一 亠 厶 川	方 丿 一 巟	方 丿 一 㐬
蒥	草 留	艸 留	艹 留
蓅	草 流	艸 流	艹 流
遛	辵 留	辶 留
馏	食 留	饣 留
骝	马 留
榴	木 留
瑠	玉 留	王 留
飗	风 留
劉	卯 金 刀	卯 金 刂
瑬	流 玉
瘤	病 留	疒 留
磂	石 留
镏	金 留	钅 留
駠	馬 卯
鹠	留 鸟
橊	木 畱
璢	玉 畱	王 畱
疁	田 翏
镠	金 翏	钅 翏
癅	病 畱	疒 畱
蟉	虫 翏
蟉	蟲 翏	虫 翏
駵	馬 丣
嚠	口 劉
懰	心 劉	忄 劉
瀏	水 卯 金 刀	氵 卯 金 刂
藰	草 劉	艸 劉	艹 劉
鎏	流 金
鎦	金 留	釒 留
麍	鹿 亠 厶 川	鹿 巟	鹿 㐬
鏐	金 翏	釒 翏
飀	風 留
鐂	金 畱	釒 畱
騮	馬 留
飅	風 畱
鰡	魚 留
鶹	留 鳥
驑	馬 畱
柳	木 卯
栁	木 夕 卩
珋	玉 卯	王 卯
桺	木 丣
绺	丝 咎	纟 咎
锍	金 亠 厶 川	钅 亠 厶 川	金 巟	钅 巟	金 㐬 鋶	钅 㐬
鉚	金 卯	釒 卯
綹	絲 咎	糹 咎	糸 咎
熮	火 翏
罶	网 留	罒 留
鋶	金 亠 厶 川	釒 亠 厶 川	金 巟	釒 巟	金 㐬	釒 㐬
橮	木 貿
嬼	女 劉
羀	网 畱	罒 畱
六	亠 八
畂	田 久
翏	羽 人 彡
塯	土 留
廇	广 留
澑	水 畱	氵 畱
磟	石 翏
鹨	翏 鸟
霤	雨 留
餾	食 留	飠 留
雡	翏 隹
飂	風 翏
鬸	鬲 留
鷚	翏 鳥
龙	尤 丿
屸	山 工
咙	口 龙
泷	水 龙	氵 龙
茏	草 龙	艸 龙	艹 龙
昽	日 龙
栊	木 龙
珑	玉 龙	王 龙
胧	月 龙
眬	目 龙
砻	龙 石
竜	立 电
笼	竹 龙
聋	龙 耳
隆	阜 夂 生	阝 夂 生	阜 夕 生	阝 夕 生
湰	水 夂 一 生	氵 夂 一 生
滝	水 竜	氵 竜
嶐	山 隆
漋	水 隆	氵 隆
蕯	草 隆	艸 隆	艹 隆
癃	病 隆	疒 隆
窿	穴 隆
篭	竹 竜
龍	立 月 一 乛 一 乚 三
嚨	口 龍
巃	山 龍
巄	山 龍
瀧	水 龍	氵 龍
蘢	草 龍	艸 龍	艹 龍
鏧	殸 金
霳	雨 隆
曨	日 龍
朧	月 龍
櫳	木 龍
爖	火 龍
瓏	玉 龍	王 龍
矓	目 龍
礱	龍 石
礲	石 龍
襱	衣 龍	衤 龍
龒	龍 示
籠	竹 龍
聾	龍 耳
蠪	龍 蟲	龍 虫
蠬	蟲 龍	虫 龍
豅	谷 龍
躘	足 龍
鑨	金 龍	釒 龍
靇	雨 龍
驡	龍 馬
鸗	龍 鳥
陇	阜 龙	阝 龙
垄	土 龙
垅	土 龙
拢	手 龙	扌 龙	才 龙
篢	竹 貢
儱	人 龍	亻 龍
隴	阜 龍	阝 龍
壟	土 龍
壠	土 龍
攏	手 龍	扌 龍	才 龍
竉	穴 龍
龓	有 龍
哢	口 弄
梇	木 弄
徿	彳 龍
贚	貝 龍
瞜	目 婁
剅	豆 刀	豆 刂
娄	米 女
偻	人 娄	亻 娄
婁	口 十 口 女	口 一 中 女
喽	口 娄
溇	水 娄	氵 娄
蒌	草 娄	艸 娄	艹 娄
僂	人 婁	亻 婁
楼	木 娄
嘍	口 婁
廔	广 婁
慺	心 婁	忄 婁
漊	水 婁	氵 婁
蔞	草 婁	艸 婁	艹 婁
遱	辵 婁	辶 婁
樓	木 婁
熡	火 婁
耧	耒 娄
蝼	虫 娄
耬	耒 婁
艛	舟 婁
螻	蟲 婁	虫 婁
謱	言 婁	訁 婁
軁	身 婁
髅	骨 娄
鞻	革 婁
髏	骨 婁
嵝	山 娄
搂	手 娄	扌 娄	才 娄
塿	土 婁
嶁	山 婁
摟	手 婁	扌 婁	才 婁
甊	婁 瓦
篓	竹 娄
簍	竹 婁
陋	阜 丨 一 丙	阝 丨 一 丙	阜 𠃊 丙	阝 𠃊 丙
屚	尸 雨
漏	水 屚	氵 屚
瘘	病 娄	疒 娄
镂	金 娄	钅 娄
瘺	病 屚	疒 屚
瘻	病 婁	疒 婁
鏤	金 婁	釒 婁
噜	口 鲁
撸	手 鲁	扌 鲁
卢	卜 尸
庐	广 户
芦	草 户	艸 户	艹 户
垆	土 卢
泸	水 卢	氵 卢
炉	火 户
栌	木 卢
胪	肉 卢	月 卢
轳	车 卢
鸬	卢 鸟
玈	玄 丿 一 氏
舻	舟 卢
颅	卢 页
鲈	鱼 卢
魲	魚 戶
盧	虎 田 皿	虍 田 皿
嚧	口 盧
壚	土 盧
廬	广 盧
攎	手 盧	扌 盧	才 盧
瀘	水 盧	氵 盧
獹	犬 盧	犭 盧
璷	玉 敷	王 敷
蘆	草 盧	艸 盧	艹 盧
曥	日 盧
櫨	木 盧
爐	火 盧
瓐	玉 盧	王 盧
臚	肉 盧	月 盧
矑	目 盧
籚	竹 盧
纑	絲 盧	糹 盧	糸 盧
罏	缶 盧
艫	舟 盧
蠦	蟲 盧	虫 盧
轤	車 盧
鑪	金 盧	釒 盧
顱	盧 頁
髗	骨 盧
鱸	魚 盧
鸕	盧 鳥
黸	黑 盧
卤	卜 囗 乂
虏	虎 力	虍 力
掳	手 虏	扌 虏	才 虏
鹵	卜 囗 丰
硵	石 卤
鲁	鱼 日
虜	虎 男	虍 男
塷	土 鹵
滷	水 鹵	氵 鹵
蓾	草 鹵	艸 鹵	艹 鹵
樐	木 鹵
澛	氵 鲁
魯	魚 日
擄	手 虜	扌 虜	才 虜
橹	木 鲁
磠	石 鹵
镥	金 鲁	钅 鲁
嚕	口 魯
擼	手 魯	扌 魯	才 魯
瀂	水 魯	氵 魯
櫓	木 魯
氌	毛 魯
艣	舟 虜
鏀	金 鹵	釒 鹵
艪	舟 魯
鐪	金 虜	釒 虜
鑥	金 魯	釒 魯
圥	土 儿
甪	丶 用
陆	阜 击	阝 击
侓	人 聿	亻 聿
坴	土 八 土
彔	彑 水
录	彐 水
峍	山 聿
勎	坴 力
赂	贝 各
辂	车 各
陸	阜 坴	阝 坴
娽	女 录
淕	水 坴	氵 坴
淥	水 彔	氵 彔
渌	水 录	氵 录
硉	石 聿
菉	草 彔	艸 彔	艹 彔
逯	辵 彔	辶 彔
鹿	广 乛 一 丨 丨 比
椂	木 录
琭	玉 彔	王 彔
禄	示 录	礻 录
祿	示 彔	礻 彔
僇	人 翏	亻 翏
剹	翏 刀	翏 刂
勠	翏 力
盝	彔 皿
睩	目 彔
碌	石 彔
碌	石 录
稑	禾 坴
賂	貝 各
路	足 各
塶	土 鹿
廘	广 鹿
摝	手 鹿	扌 鹿	才 鹿
漉	水 鹿	氵 鹿
箓	竹 录
粶	米 录
蔍	草 鹿	艸 鹿	艹 鹿
戮	翏 戈
樚	木 鹿
熝	火 鹿
膔	肉 鹿	月 鹿
觮	角 录
趢	走 录
踛	足 坴
辘	车 鹿
醁	酉 彔
潞	水 路	氵 路
穋	禾 翏
蕗	草 路	艸 路	艹 路
錄	金 彔	釒 彔
録	金 录	釒 录
錴	金 坴	釒 坴
璐	玉 路	王 路
簏	竹 鹿
螰	虫 鹿
螰	蟲 鹿	虫 鹿
簶	竹 祿
蹗	足 鹿
轆	車 鹿
騄	馬 彔
鹭	路 鸟
簬	竹 路
簵	竹 輅
鏕	金 鹿	釒 鹿
鯥	魚 坴
鵦	录 鳥
鵱	坴 鳥
麓	林 鹿
鏴	金 路	釒 路
露	雨 路
騼	馬 鹿
籙	竹 錄
虂	草 露	艸 露	艹 露
鷺	路 鳥
氇	毛 鲁
驴	马 户
闾	门 吕
榈	木 闾	木 门 吕
閭	門 呂
馿	馬 戶
氀	婁 毛
膢	肉 婁	月 婁
櫚	木 閭	木 門 呂
藘	草 慮	艸 慮	艹 慮
鷜	婁 鳥
驢	馬 盧
吕	口 口
呂	口 丶 口
侣	人 吕	亻 吕
郘	呂 邑	呂 阝
侶	人 呂	亻 呂
挔	手 衣	扌 衣	才 衣
捛	手 吕	扌 吕	才 吕
捛	手 呂	扌 呂	才 呂
捋	手 寽	扌 寽	才 寽	手 爪 寸	扌 爫 寸
旅	方 丿 一 氏
梠	木 呂
祣	示 丿 一 氏	礻 丿 一 氏
稆	禾 吕
稆	禾 呂
铝	金 吕	钅 吕
屡	尸 娄
絽	絲 呂	糹 呂	糸 呂
缕	丝 娄	纟 娄
屢	尸 婁
膂	旅 肉	旅 月
褛	衣 娄	衤 娄
鋁	金 呂	釒 呂
履	尸 復
膐	旅 肉	旅 月
褸	衣 婁	衤 婁
儢	人 慮	亻 慮
穞	禾 鲁
縷	絲 婁	糹 婁	糸 婁
穭	禾 魯
寽	爪 寸	爫 寸
垏	土 聿
律	彳 聿
虑	虎 心	虍 心
率	玄 冰 丶 丶 十	玄 冫 丶 丶 十
绿	丝 录	纟 录
嵂	山 律
氯	气 录
氯	氣 彔	气 彔
葎	草 律	艸 律	艹 律
滤	水 虑	氵 虑
綠	絲 彔	糹 彔	糸 彔
緑	絲 录	糹 录	糸 录
慮	虎 思 心	虍 思 心
箻	竹 律
膟	肉 率	月 率
勴	慮 力
繂	絲 率	糹 率	糸 率
濾	水 慮	氵 慮
櫖	木 慮
爈	火 慮
鑢	金 慮	釒 慮
娈	亦 女
孪	亦 子
峦	亦 山
挛	亦 手
栾	亦 木
鸾	亦 鸟
脔	亦 肉
滦	水 栾	氵 栾
銮	亦 金
鵉	亦 鳥
圝	囗 絲 言	囗 糸 言 糸	囗 䜌
奱	絲 言 大	糸 言 糸 大	䜌 大
孌	絲 言 女	糸 言 糸 女	䜌 女
孿	絲 言 子	糸 言 糸 子	䜌 子
巒	絲 言 山	糸 言 糸 山	䜌 山
攣	絲 言 手	糸 言 糸 手	䜌 手
曫	絲 言 日	糸 言 糸 日	䜌 日
欒	絲 言 木	糸 言 糸 木	䜌 木
灓	絲 言 水	糸 言 糸 水	䜌 水
羉	目 絲 言	目 糸 言 糸	目 䜌	罒 䜌
臠	絲 言 肉	糸 言 糸 肉	䜌 肉
圞	囗 欒
灤	水 欒	氵 欒
虊	草 欒	艸 欒	艹 欒
鑾	絲 言 金	糸 言 糸 金	䜌 金
癴	病 攣	疒 攣
癵	病 臠	疒 臠
鸞	絲 言 鳥	糸 言 糸 鳥	䜌 鳥
卵	卯 丶 丶	丿 𠄌 丿 丶 卪
乱	舌 乙	舌 乚
釠	金 几	釒 几
亂	爪 龴 冂 厶 又 乙	爫 龴 冂 厶 又 乚
掠	手 京	扌 京	才 京
略	田 各
畧	田 各
锊	金 寽	钅 寽
稤	禾 京
圙	囗 八 面
鋝	金 寽	釒 寽
鋢	金 孚	釒 孚
擽	手 樂	扌 樂	才 樂
抡	手 仑	扌 仑	才 仑
掄	手 侖	扌 侖	才 侖
仑	人 匕
伦	人 仑	亻 仑
囵	囗 仑
沦	水 仑	氵 仑
纶	丝 仑	纟 仑
侖	人 一 冊
轮	车 仑
倫	人 侖	亻 侖
陯	阜 侖	阝 侖
圇	囗 侖
婨	女 侖
崘	山 侖
崙	山 侖
惀	心 侖	忄 侖
淪	水 侖	氵 侖
菕	草 侖	艸 侖	艹 侖
棆	木 侖
腀	肉 侖	月 侖
綸	絲 侖	糹 侖	糸 侖
蜦	蟲 侖	虫 侖
踚	足 侖
輪	車 侖
錀	金 侖	釒 侖
鯩	魚 侖
埨	土 侖
碖	石 侖
稐	禾 侖
耣	耒 侖
论	言 仑	讠 仑
溣	水 侖	氵 侖
論	言 侖	訁 侖
罗	网 夕	罒 夕	罓 夕
啰	口 罗
頱	寽 頁
囉	口 羅
猡	犬 罗	犭 罗
脶	肉 呙	月 呙	月 口 内
萝	草 罗	艸 罗	艹 罗
逻	辵 罗	辶 罗
椤	木 罗
腡	肉 咼	月 咼
覙	尔 見
锣	金 罗	钅 罗
箩	竹 罗
骡	马 累
镙	金 累	钅 累
螺	虫 累
螺	蟲 累	虫 累
羅	网 維	罒 維	罓 維
覶	爪 龴 冂 厶 又 見	爫 龴 冂 厶 又 見
鏍	金 累	釒 累
儸	人 羅	亻 羅
覼	爾 見
騾	馬 累
攞	手 羅	扌 羅	才 羅
玀	犬 羅	犭 羅
蘿	草 羅	艸 羅	艹 羅
邏	辵 羅	辶 羅
欏	木 羅
驘	亡 口 月 馬 凡
鸁	亡 口 月 鳥 凡
籮	竹 羅
鑼	金 羅	釒 羅
饠	食 羅
剆	艮 刀	艮 刂
倮	人 果	亻 果
蓏	草 瓜 瓜	艸 瓜 瓜	艹 瓜 瓜
裸	衣 果	衤 果
躶	身 果
瘰	病 累	疒 累
蠃	亡 口 月 虫 凡
蠃	亡 口 月 蟲 凡	亡 口 月 虫 凡
臝	亡 口 月 果 凡
曪	日 羅
癳	病 纍	疒 纍
泺	水 乐	氵 乐
峈	山 各
洛	水 各	氵 各
络	丝 各	纟 各
荦	草 冖 牛	艸 冖 牛	艹 冖 牛
骆	马 各
珞	玉 各	王 各
硦	石 弄
笿	竹 各
絡	絲 各	糹 各	糸 各
落	草 洛	艸 洛	艹 洛
摞	手 累	扌 累	才 累
漯	水 累	氵 累
犖	火 火 冖 牛	𤇾 牛
鉻	金 各	釒 各
雒	各 隹
駱	馬 各
鮥	魚 各
鴼	鳥 各
鵅	各 鳥
濼	水 樂	氵 樂
纙	絲 羅	糹 羅	糸 羅
呣	口 母
妈	女 马
孖	子 子
媽	女 馬
嬤	女 麻 幺
嬷	女 麽
麻	广 林
痲	病 林	疒 林
蔴	草 麻	艸 麻	艹 麻
犘	麻 牛
蟆	虫 莫
蟆	蟲 莫	虫 莫
蟇	莫 虫
蟇	莫 蟲	莫 虫
马	乛 乛 一
玛	玉 马	王 马
码	石 马
蚂	虫 马
溤	水 馬	氵 馬
瑪	玉 馬	王 馬
碼	石 馬
螞	蟲 馬	虫 馬
鎷	金 馬	釒 馬
鰢	魚 馬
鷌	鳥 馬
犸	犬 马	犭 马
杩	木 马
祃	示 马	礻 马
閁	門 丿
骂	口 口 马
唛	口 麦
傌	人 馬	亻 馬
獁	犬 馬	犭 馬
睰	目 若
嘜	口 麥
榪	木 馬
禡	示 馬	礻 馬
罵	网 馬	罒 馬	罓 馬	口 口 馬
駡	口 口 馬
礣	石 蔑
鬕	髟 莫
吗	口 马
嗎	口 馬
嘛	口 麻
埋	土 里
薶	草 貍	艸 貍	艹 貍
霾	雨 貍
买	乛 头
荬	草 买	艸 买	艹 买
買	网 貝	罒 貝	罓 貝
嘪	口 買
蕒	草 買	艸 買	艹 買
鷶	買 鳥
劢	万 力
迈	辵 万	辶 万
佅	人 未	亻 未
売	士 冖 儿
麦	丰 夕	丰 夂
卖	十 买
脉	肉 永	月 永	肉 𠂢 脈	月 𠂢 脈
脈	肉 厂 氏	月 厂 氏	肉 𠂢	月 𠂢
麥	來 夕	來 夂
衇	血 厂 氏	血 𠂢
勱	萬 力
賣	士 買
邁	辵 萬	辶 萬
霡	雨 脉
霢	雨 脈
嫚	女 曼
颟	草 两 页	艸 两 页	艹 两 页
姏	女 甘
悗	心 免	忄 免
蛮	亦 虫
僈	人 曼	亻 曼
谩	言 曼	讠 曼
慲	心 廿 冂 丨 入 入	忄 廿 冂 丨 入 入	心 㒼	忄 㒼
馒	食 曼	饣 曼
樠	木 廿 冂 丨 入 入	木 廿 冂 丨 入 入	木 㒼
瞒	目 草 两	目 艹 两
瞞	目 廿 冂 丨 入 入	目 㒼
鞔	革 免
蹒	足 草 两	足 艹 两
謾	言 曼	訁 曼
饅	食 曼	飠 曼
鳗	鱼 曼
顢	廿 冂 丨 入 入 頁	㒼 頁
鬗	髟 廿 冂 丨 入 入	髟 㒼
鬘	髟 曼
鰻	魚 曼
蠻	絲 言 蟲	糸 言 糸 蟲	絲 言 虫	䜌 蟲	䜌 虫
屘	尾 子
満	水 草 両	氵 艸 両	氵 艹 両
睌	目 免
满	水 草 两	氵 艸 两
满	水 草 两	氵 艹 两
滿	水 廿 冂 丨 入 入	氵 廿 冂 丨 入 入	水 㒼	氵 㒼
螨	虫 草 两	虫 艸 两	虫 艹 两
襔	衣 廿 冂 丨 入 入	衤 廿 冂 丨 入 入	衣 㒼	衤 㒼
蟎	蟲 廿 冂 丨 入 入	虫 廿 冂 丨 入 入	蟲 㒼	虫 㒼
鏋	金 廿 冂 丨 入 入	釒 廿 冂 丨 入 入	金 㒼	釒 㒼
矕	絲 言 目	糸 言 糸 目	䜌 目
曼	曰 目 又
鄤	曼 邑	曼 阝
墁	土 曼
幔	巾 曼
慢	心 曼	忄 曼
摱	手 曼	扌 曼	才 曼
漫	水 曼	氵 曼
獌	犬 曼	犭 曼
缦	丝 曼	纟 曼
蔄	草 問	艸 問	艹 問
蔓	草 曼	艸 曼	艹 曼
槾	木 曼
熳	火 曼
澷	水 曰 网 方	氵 曰 罒 方
镘	金 曼	钅 曼
縵	絲 曼	糹 曼	糸 曼
鏝	金 曼	釒 曼
牤	牛 亡	牜 亡
邙	亡 邑	亡 阝
吂	亡 口
忙	心 亡	忄 亡
汒	水 亡	氵 亡
芒	草 亡	艸 亡	艹 亡
尨	尤 彡
杗	木 亡
杧	木 亡
氓	亡 民
盲	目 亡
恾	心 芒	忄 芒
笀	竹 亡
茫	草 水 亡	艸 氵 亡	艹 氵 亡
哤	口 尨
娏	女 尨
庬	广 尨
浝	水 尨	氵 尨
狵	犬 尨	犭 尨
牻	牛 尨	牜 尨
硭	石 芒
釯	金 亡	釒 亡
铓	金 芒	钅 芒
痝	病 尨	疒 尨
蛖	虫 尨
蛖	蟲 尨	虫 尨
鋩	金 芒	釒 芒
駹	馬 尨
莽	草 大 廾	艸 大 廾	艹 大 廾
莾	草 奔	艸 奔	艹 奔
硥	石 尨
茻	屮 屮 屮 屮	艸 艸
壾	壴 巨
漭	水 莽	氵 莽
蟒	虫 莽
蟒	蟲 莽	虫 莽
蠎	虫 莾
蠎	蟲 莾	虫 莾
猫	犬 苗	犭 苗
貓	豕 苗
毛	丿 一 匕
矛	予 丿
枆	木 毛
牦	牛 毛	牜 毛
茅	草 矛	艸 矛	艹 矛
茆	草 卯	艸 卯	艹 卯
旄	方 丿 一 毛
罞	网 矛	罒 矛
兞	克 毛
渵	水 苗	氵 苗
軞	車 毛
酕	酉 毛
堥	敄 土
锚	金 苗	钅 苗
髦	髟 毛
氂	未 攴 厂 毛	未 攵 厂 毛
犛	未 攴 厂 牛	未 攵 厂 牛
蝥	敄 虫
蝥	敄 蟲	敄 虫
髳	髟 矛
錨	金 苗	釒 苗
蟊	矛 虫 虫
蟊	矛 蟲 蟲	矛 虫 虫
鶜	茅 鳥
冇	一 丿 冂
卯	卬 丿	丿 𠄌 丿 卩
夘	夕 卩
戼	乛 匚 戶
峁	山 卯
泖	水 卯	氵 卯
昴	日 卯
铆	金 卯	钅 卯
笷	竹 卯
蓩	草 務	艸 務	艹 務
皃	白 儿
芼	草 毛	艸 毛	艹 毛
冐	冂 二 月	曰 月	日 月
茂	草 戊	艸 戊	艹 戊
冒	冃 目	冂 二 目	曰 目	日 目
柕	木 矛
眊	目 毛
贸	卯 贝
耄	老 毛
袤	衣 矛
覒	毛 見
媢	女 冒
帽	巾 冒
萺	草 冒	艸 冒	艹 冒
貿	卯 貝
鄚	莫 邑	莫 阝
愗	敄 心
暓	敄 日
楙	林 矛	木 矛 木
毷	冒 毛
瑁	玉 冒	王 冒
瞀	敄 目
貌	豸 白 儿
鄮	冒 邑	冒 阝
蝐	虫 冒
蝐	蟲 冒	虫 冒
懋	楙 心
嚒	口 麼
么	丿 厶
麼	麻 幺
嚜	口 墨
呅	口 文
坆	土 攴	土 攵
沒	水 勹 又	氵 勹 又
没	水 殳	氵 殳
枚	木 攴	木 攵
玫	玉 攴	王 攵
苺	草 母	艸 母	艹 母
栂	木 母
眉	尸 丶 目
娒	女 每
脄	肉 灰	月 灰
莓	草 每	艸 每	艹 每
梅	木 每
珻	玉 每	王 每
脢	肉 每	月 每
郿	眉 邑	眉 阝
堳	土 眉
媒	女 某
嵋	山 眉
湄	水 眉	氵 眉
湈	水 某	氵 某
猸	犬 眉	犭 眉
睂	仌 丨 厂 目
葿	草 眉	艸 眉	艹 眉
楣	木 眉
楳	木 某
煤	火 某
瑂	玉 眉	王 眉
禖	示 某	礻 某
腜	肉 某	月 某
塺	麻 土
槑	呆 呆
酶	酉 每
镅	金 眉	钅 眉
鹛	眉 鸟
鋂	金 每	釒 每
霉	雨 母
穈	麻 禾
徾	彳 山 一 言 攴	彳 山 一 言 攵
鎇	金 眉	釒 眉
矀	目 微
攗	手 麋	扌 麋	才 麋
蘪	草 麋	艸 麋	艹 麋
鶥	眉 鳥
黴	彳 山 一 黑 攴	彳 山 一 黑 攵
毎	丿 一 毋
每	丿 一 母
凂	冰 免	冫 免
美	羊 大
挴	手 每	扌 每	才 每
浼	水 免	氵 免
媄	女 美
嵄	山 美
渼	水 美	氵 美
媺	女 彳 山 一 儿 攴
媺	女 山 一 几 攴	女 山 一 几 文
镁	金 美	钅 美
嬍	女 彳 山 一 王 攴	女 彳 山 一 王 攵
嬍	女 山 一 王 攴	女 山 一 王 攵
燘	火 閔
鎂	金 美	釒 美
黣	黑 每
妹	女 未
抺	手 未	扌 未	才 未
沬	水 未	氵 未
昧	日 未
祙	示 未	礻 未
袂	衣 夬	衤 夬
眛	目 未
媚	女 眉
寐	宀 爿 未
痗	病 每	疒 每
跊	足 未
鬽	鬼 彡
煝	火 眉
睸	目 眉
韎	韋 未
魅	鬼 未
篃	竹 眉
蝞	虫 眉
蝞	蟲 眉	虫 眉
门	丶 丨 乛
扪	手 门	扌 门
玧	玉 允	王 允
钔	金 门	钅 门
門	尸 一 匚 一 亅
閅	門 丁
捫	手 門	扌 門	才 門
菛	草 門	艸 門	艹 門
璊	玉 廿 冂 丨 入 入	王 廿 冂 丨 入 入	玉 㒼	王 㒼
鍆	金 門	釒 門
亹	亠 舋
虋	草 釁	艸 釁	艹 釁
闷	门 心
焖	火 闷
悶	門 心
暪	日 廿 冂 丨 入 入	日 廿 冂 丨 入 入	日 㒼
燜	火 悶
懑	满 心
懣	滿 心
们	人 门	亻 门
們	人 門	亻 門
擝	手 盟	扌 盟	才 盟
甿	田 亡
虻	虫 亡
虻	蟲 亡	虫 亡
冡	冖 一 豕
莔	草 囧	艸 囧	艹 囧
萌	草 明	艸 明	艹 明
溕	水 冡	氵 冡
盟	明 皿
蒙	草 冡	艸 冡	艹 冡
甍	草 网 冖 瓦	艸 网 冖 瓦	艹 罒 冖 瓦
儚	人 夢	亻 夢
橗	木 萌
瞢	草 网 冖 目	艸 网 冖 目	艹 罒 冖 目
蕄	草 悶	艸 悶	艹 悶
蝱	亡 虫 虫
蝱	亡 蟲 蟲	亡 虫 虫
鄳	黽 邑	黽 阝
鄸	夢 邑	夢 阝
幪	巾 蒙
懞	心 蒙	忄 蒙
濛	水 蒙	氵 蒙
曚	日 蒙
朦	月 蒙
檬	木 蒙
氋	蒙 毛
矇	目 蒙
礞	石 蒙
鯍	魚 亠 厶 川	魚 巟	魚 㐬
鹲	蒙 鸟
艨	舟 蒙
蘉	草 网 冖 侵	艸 罒 冖 侵	艹 罒 冖 侵
矒	目 瞢
霿	雨 敄 目
靀	雨 蒙
饛	食 蒙
顭	夢 頁
鼆	冥 黽
鸏	蒙 鳥
勐	孟 力
猛	犬 孟	犭 孟
瓾	委 瓦
锰	金 孟	钅 孟
艋	舟 孟
蜢	虫 孟
蜢	蟲 孟	虫 孟
懜	心 夢	忄 夢
獴	犬 蒙	犭 蒙
錳	金 孟	釒 孟
懵	心 瞢	忄 瞢
蠓	虫 蒙
蠓	蟲 蒙	虫 蒙
鯭	魚 孟
孟	子 皿
梦	木 木 夕
夢	草 网 冖 夕	艸 网 冖 夕	艹 罒 冖 夕
夣	亠 厶 网 冖 夕	亠 厶 罒 冖 夕
霥	雨 冡
掹	手 孟	扌 孟	才 孟
咪	口 米
眯	目 米
瞇	目 迷
冞	冖 米
弥	弓 尔
祢	示 尓	礻 尔
迷	辵 米	辶 米
猕	犭 弥
谜	言 迷	讠 迷
蒾	草 迷	艸 迷	艹 迷
詸	言 米	訁 米
謎	言 迷	訁 迷
醚	酉 迷
彌	弓 爾
擟	手 爾	扌 爾	才 爾
糜	麻 米
縻	麻 糸
麊	米 鹿
麋	鹿 米
禰	示 爾	礻 爾
靡	麻 非
瀰	水 彌	氵 彌
獼	犬 彌
麛	鹿 弭
镾	長 爾	镸 爾
戂	心 靡	忄 靡
攠	手 靡	扌 靡	才 靡
瓕	彌 玉
蘼	草 靡	艸 靡	艹 靡
爢	靡 火	靡 灬
醾	酉 糜
醿	酉 縻
鸍	爾 鳥
釄	酉 靡
米	丷 木
芈	草 卝 二 丨	艸 卝 二 丨	艹 卝 二 丨
侎	人 米	亻 米
沵	水 尔	氵 尔
羋	卝 丨 干
弭	弓 耳
洣	水 米	氵 米
敉	米 攴	米 攵
眫	目 半
粎	米 尺
脒	肉 米	月 米
渳	水 弭	氵 弭
葞	草 弭	艸 弭	艹 弭
蔝	草 眯	艸 眯	艹 眯
銤	金 米	釒 米
濔	水 爾	氵 爾
孊	女 靡
灖	水 靡	氵 靡
冖	丶 乛
糸	幺 小
汨	水 曰	氵 日
沕	水 勿	氵 勿
宓	宀 必
泌	水 必	氵 必
觅	爪 见	爫 见
峚	山 圶
祕	示 必	礻 必
宻	宀 又 丷 山
秘	禾 必
密	宀 必 山	宓 山
淧	水 宓	氵 宓
覓	爪 見	爫 見
覔	不 見
幂	冖 日 大 巾
谧	言 必 皿	讠 必 皿
塓	土 冥
幎	巾 冥
覛	厂 氏 見	𠂢 見
嘧	口 密
榓	木 必 皿
滵	水 密	氵 密
漞	水 覓	氵 覓
熐	火 冥
蔤	草 密	艸 密	艹 密
蜜	宀 必 虫	宓 虫
蜜	宀 必 蟲	宀 必 虫	宓 蟲	宓 虫
鼏	冖 鼎
冪	冖 幕
樒	木 密
幦	辟 巾
濗	水 幕	氵 幕
藌	草 蜜	艸 蜜	艹 蜜
謐	言 必 皿	訁 必 皿
櫁	木 蜜
簚	竹 网 戈 巾	竹 罒 戈 巾
羃	网 幕	罒 幕
宀	丶 冖
芇	草 巾	艸 巾	艹 巾
眠	目 民
婂	女 帛
绵	丝 帛	纟 帛
媔	女 面
棉	木 帛
綿	絲 帛	糹 帛	糸 帛
緜	帛 系
臱	自 穴 方
蝒	虫 面
蝒	蟲 面	虫 面
嬵	女 綿
檰	木 綿
櫋	木 臱
矈	目 臱
矊	目 綿
矏	目 臱
丏	一 𠃊 丨 𠃌	丐  丨
汅	水 丂	氵 丂
免	刀 口 丨 儿
沔	水 丏	氵 丏
黾	口 电
勉	免 力
眄	目 丏
娩	女 免
偭	人 面	亻 面
冕	冃 免	冂 二 免
冕	冃 勉	冂 二 勉	曰 勉	日 勉
勔	面 力
渑	水 黾	氵 黾
喕	口 面
愐	心 面	忄 面
湎	水 面	氵 面
缅	丝 面	纟 面
葂	草 勉	艸 勉	艹 勉
絻	絲 免	糹 免	糸 免
腼	肉 面	月 面
黽	冂 一
緬	絲 面	糹 面	糸 面
澠	水 黽	氵 黽
鮸	魚 免
靣	一 丶 回
面	一 丶 囬	一 丶 囗 丨 丨 一 一
糆	米 面
麪	麥 丐
麫	麥 丏
麺	麦 面
麵	麥 面
喵	口 苗
苗	草 田	艸 田	艹 田
媌	女 苗
描	手 苗	扌 苗	才 苗
瞄	目 苗
鹋	苗 鸟
嫹	女 黃
緢	絲 苗	糹 苗	糸 苗
鶓	苗 鳥
鱙	魚 堯
杪	木 少
眇	目 少
秒	禾 少
淼	水 水 水
渺	水 目 少	氵 目 少
缈	丝 目 少	纟 目 少
篎	竹 眇
緲	絲 目 少	糹 目 少	糸 目 少
藐	草 貌	艸 貌	艹 貌
邈	辵 貌	辶 貌
妙	女 少
庙	广 朝 廟	广 由 廟
玅	玄 少
竗	立 少
庿	广 苗
廟	广 朝	广 由
乜	卩 乚
吀	口 千
咩	口 羊
哶	口 芈	口 羊
孭	子 貝
灭	一 火
烕	戊 一 火
覕	必 見
搣	手 烕	扌 烕	才 烕
滅	水 戊 一 火	氵 戊 一 火	水 烕	氵 烕
蔑	草 网 戍	艸 罓 戍	艹 罒 戍
薎	草 卝	艸 卝	艹 卝
鴓	必 鳥
幭	巾 蔑
懱	心 蔑	忄 蔑
篾	竹 网 戍	竹 罒 戍	竹 罓 戍
櫗	木 蔑
蠛	虫 蔑
蠛	蟲 蔑	虫 蔑
衊	血 蔑
鑖	金 蔑	釒 蔑
鱴	魚 蔑
民	乛 一 𠄌 一 𠄌
姄	女 民
岷	山 民
忞	文 心
怋	心 民	忄 民
旻	日 文
旼	日 文
苠	草 民	艸 民	艹 民
珉	玉 民	王 民
盿	目 文
砇	石 文
罠	网 民	罒 民
崏	山 昏
捪	手 昏	扌 昏	才 昏
琘	玉 昏	王 昏
琝	玉 旻	王 旻
缗	丝 昬	纟 昬
瑉	玉 昬	王 昬
痻	病 昏	疒 昏
碈	石 昏
鈱	金 民	釒 民
緍	絲 昏	糹 昏	糸 昏
緡	絲 昬	糹 昬	糸 昬
錉	金 昏	釒 昏
鴖	民 鳥
鍲	金 昬	釒 昬
皿	冊 一
冺	冰 民	冫 民
刡	民 刀	民 刂
闵	门 文
抿	手 民	扌 民	才 民
泯	水 民	氵 民
勄	每 力
敃	民 攴	民 攵
闽	门 虫
悯	心 闵	忄 闵
敏	每 攴	每 攵
笢	竹 民
惽	心 昬	忄 昬
湣	水 昬	氵 昬
閔	門 文
愍	敃 心
敯	昬 攴
暋	敃 日
閩	門 蟲	門 虫
僶	人 黽	亻 黽
慜	敏 心
憫	心 閔	忄 閔
潣	水 閔	氵 閔
簢	竹 閔
鳘	敏 鱼
蠠	面 虫 虫
蠠	面 蟲 蟲	面 虫 虫
鰵	敏 魚
名	夕 口
明	日 月
鸣	口 鸟
洺	水 名	氵 名
眀	目 月
茗	草 名	艸 名	艹 名
冥	冖 日 大
朙	囧 月
眳	目 名
铭	金 名	钅 名
鄍	冥 邑	冥 阝
嫇	女 冥
溟	水 冥	氵 冥
猽	犬 冥	犭 冥
蓂	草 冥	艸 冥	艹 冥
暝	日 冥
榠	木 冥
銘	金 名	釒 名
鳴	口 鳥
瞑	目 冥
螟	虫 冥
螟	蟲 冥	虫 冥
覭	冥 見
佲	人 名	亻 名
姳	女 名
凕	冰 冥	冫 冥
慏	心 冥	忄 冥
酩	酉 名
命	人 一 叩
詺	言 名	訁 名
谬	言 翏	讠 翏
謬	言 翏	訁 翏
摸	手 莫	扌 莫	才 莫
庅	广 么
尛	小 小 小
谟	言 莫	讠 莫
嫫	女 莫
馍	食 莫	饣 莫
摹	莫 手
模	木 莫
膜	肉 莫	月 莫
麽	麻 么
摩	麻 手
橅	木 無
磨	麻 石
糢	米 莫
謨	言 莫	訁 莫
謩	莫 言
嚤	口 摩
擵	手 摩	扌 摩	才 摩
饃	食 莫	飠 莫
嚩	口 縛
嚰	口 磨
蘑	草 磨	艸 磨	艹 磨
髍	骨 麻
魔	麻 鬼
劘	靡 刀	靡 刂
饝	食 磨
抹	手 末	扌 末	才 末
懡	心 麽	忄 麽
末	木 一
劰	白 力
圽	土 勿
妺	女 末
帓	巾 末
歾	歹 勿
歿	歹 勹 又
殁	歹 殳
沫	水 末	氵 末
茉	草 末	艸 末	艹 末
陌	阜 百	阝 百
帞	巾 百
昩	日 末
枺	木 末
皌	白 末
眜	目 末
眿	目 永
砞	石 末
秣	禾 末
莈	草 沒	艸 沒	艹 沒
莫	草 日 大	艸 日 大	艹 日 大	艹 曰 大
眽	目 厂 氏
眽	目 厂 氏	目 𠂢
粖	米 末
絈	絲 白	糹 白	糸 白
湐	水 柏	氵 柏
蛨	虫 百
蛨	蟲 百	虫 百
貃	豸 白
嗼	口 莫
塻	土 莫
寞	宀 莫
漠	水 莫	氵 莫
獏	犬 莫	犭 莫
蓦	莫 马
貊	豸 百
暯	日 莫
銆	金 百	釒 百
靺	革 末
嫼	女 墨
黙	里 犬 火	里 犬 灬
瘼	病 莫	疒 莫
瞐	目 目 目
瞙	目 莫
镆	金 莫	钅 莫
魩	魚 勿
墨	黑 土
默	黑 犬
瀎	水 蔑	氵 蔑
貘	豸 莫
藦	草 摩	艸 摩	艹 摩
蟔	虫 黑
蟔	蟲 黑	虫 黑
鏌	金 莫	釒 莫
爅	火 墨
驀	莫 馬
礳	石 磨
纆	絲 墨	糹 墨	糸 墨
耱	耒 磨
哞	口 牟
牟	厶 牛
侔	人 牟	亻 牟
劺	牟 力
恈	心 牟	忄 牟
洠	水 牟	氵 牟
眸	目 牟
谋	訁 某	讠 某
蛑	虫 牟
蛑	蟲 牟	虫 牟
缪	丝 翏	纟 翏
踎	足 否
鉾	金 牟	釒 牟
謀	言 某	訁 某
瞴	目 無
繆	絲 翏	糹 翏	糸 翏
鍪	敄 金
鴾	牟 鳥
麰	麥 牟
某	甘 木
毪	毛 牟
氁	毛 莫
墲	土 無
母	丨 一 二 丶 丶 亅
亩	亠 田
牡	牛 土	牜 土
坶	土 母
姆	女 母
拇	手 母	扌 母	才 母
峔	山 老
牳	牛 母	牜 母
畆	亩 厶
畒	亩 人
胟	肉 母	月 母
畝	亩 久
畞	十 田 久
砪	石 母
畮	田 母
鉧	金 母	釒 母
踇	足 每
木	十 人	十 八	一 小
仫	人 么	亻 么
目	囗 二
沐	水 木	氵 木
狇	犬 木	犭 木
炑	火 木
牧	牛 攴	牜 攵
苜	草 目	艸 目	艹 目
毣	羽 毛
莯	草 沐	艸 沐	艹 沐
蚞	虫 木
蚞	蟲 木	虫 木
钼	金 目	钅 目
募	莫 力
雮	雨 毛
墓	莫 土
幕	莫 巾
幙	巾 莫
慔	心 莫	忄 莫
楘	敄 木
睦	目 坴	目 土 儿 土
鉬	金 目	釒 目
慕	莫 心	莫 小 丶
暮	莫 日
艒	舟 冒
霂	雨 沐
穆	禾 白 小 彡
縸	絲 莫	糹 莫	糸 莫
鞪	敄 革
嗯	口 恩
拏	奴 手
拿	合 手
挐	如 手
嗱	口 拿
镎	金 拿	钅 拿
鎿	金 拿	釒 拿
乸	也 母
哪	口 那
雫	雨 下
那	月 邑	月 阝
吶	口 內
呐	口 内
妠	女 內
纳	丝 内	纟 内
肭	肉 內	月 內
娜	女 那
衲	衣 內	衤 內
衲	衣 内	衤 内
钠	金 内	钅 内
納	絲 內	糹 內	糸 內
袦	衣 出	衤 出
捺	手 奈	扌 奈	才 奈
笝	竹 囗 又
豽	豸 內
軜	車 內
貀	豸 出
鈉	金 內	釒 內
蒳	草 納	艸 納	艹 納
靹	革 內
魶	魚 內
腉	肉 兒	月 兒
熋	能 火
摨	手 犀	扌 犀	才 犀
孻	子 盡
乃	丿 乛 乛
奶	女 乃
艿	草 乃	艸 乃	艹 乃
氖	气 乃
氖	氣 乃	气 乃
疓	病 乃	疒 乃
妳	女 尔
廼	廴 西
迺	辵 西	辶 西
倷	人 奈	亻 奈
釢	金 乃	釒 乃
嬭	女 爾
奈	大 示
柰	木 示
耏	而 彡
耐	而 寸
萘	草 奈	艸 奈	艹 奈
渿	水 奈	氵 奈
鼐	乃 鼎
褦	衣 能	衤 能
螚	能 虫
螚	能 蟲	能 虫
錼	金 奈	釒 奈
囡	囗 女
男	田 力
抩	手 冉	扌 冉	才 冉
枏	木 冄
侽	人 男	亻 男
南	十 冂 丫 二
柟	木 冉
娚	女 男
畘	田 冉
莮	草 男	艸 男	艹 男
难	又 隹
喃	口 南
暔	日 南
楠	木 南
諵	言 南	訁 南
難	革 大 隹
赧	赤 卩 又
揇	手 南	扌 南	才 南
湳	水 南	氵 南
萳	草 南	艸 南	艹 南
煵	火 南
腩	肉 南	月 南
蝻	虫 南
蝻	蟲 南	虫 南
戁	難 心
婻	女 南
囔	口 囊
乪	乙 田
嚢	十 口 冖 八 井 一 衣
譨	言 農	訁 農
囊	一 口 丨 冂 口 口 井 一 衣
蠰	虫 襄
蠰	蟲 襄	虫 襄
鬞	髟 農
馕	饣 囊
欜	木 囊
饢	食 囊
擃	手 農	扌 農	才 農
曩	日 囊
攮	手 囊	扌 囊	才 囊
灢	水 囊	氵 囊
儾	人 囊	亻 囊
齉	鼻 囊
孬	不 好
呶	口 奴
怓	心 奴	忄 奴
挠	手 尧	扌 尧	才 尧
峱	丑 山
硇	石 囟
铙	金 尧	钅 尧
猱	犬 柔	犭 柔
蛲	虫 尧
詉	言 奴	訁 奴
碙	石 岡
撓	手 堯	扌 堯	才 堯
嶩	山 農
憹	心 農	忄 農
蟯	蟲 堯	虫 堯
夒	一 自 止 已 八 夕	一 自 止 已 八 夂
譊	言 堯	訁 堯
鐃	金 堯	釒 堯
巎	山 夒
垴	土 亠 乂 凵
恼	心 亠 乂 凵	忄 亠 乂 凵
悩	心 小 乂 凵	忄 小 乂 凵
脑	肉 亠 乂 凵	月 亠 乂 凵
匘	匕 巛 囟	匕 𡿺
堖	土 巛 丶 囗 乂
惱	心 巛 囟	忄 巛 囟	心 𡿺	忄 𡿺
嫐	女 男 女
瑙	玉 巛 囟	王 巛 囟
瑙	玉 巛 囟	王 巛 囟	玉 𡿺	王 𡿺
腦	肉 巛 囟	月 巛 囟	肉 𡿺	月 𡿺
碯	石 巛 囟	石 𡿺
獶	犬 憂	犭 憂
獿	犬 夒	犭 夒
闹	门 市
婥	女 卓
淖	水 卓	氵 卓
閙	門 市
鬧	鬥 市
臑	肉 需	月 需
疒	丶 厂 冫	丶 一 丬
讷	言 內	讠 內
抐	手 內	扌 內	才 內
抐	手 内	扌 内	才 内
眲	目 耳
訥	言 內	訁 內
呢	口 尼
娞	女 妥
馁	食 妥	饣 妥
脮	肉 妥	月 妥
腇	肉 委	月 委
餒	食 妥	飠 妥
鮾	魚 妥
鯘	魚 委
內	冂 入
内	冂 人
氝	气 內
氝	氣 內	气 內
錗	金 委	釒 委
恁	任 心
嫩	女 敕
嫰	女 欶
能	厶 肉 匕 匕	厶 月 匕 匕
妮	女 尼
尼	尸 匕
坭	土 尼
怩	心 尼	忄 尼
泥	水 尼	氵 尼
籾	米 刃
倪	人 兒	亻 兒
屔	丘 尼
秜	禾 尼
郳	兒 邑	兒 阝
铌	金 尼	钅 尼
埿	泥 土
婗	女 兒
淣	水 兒	氵 兒
猊	犬 兒	犭 兒
蚭	虫 尼
蚭	蟲 尼	虫 尼
棿	木 兒
跜	足 尼
腝	肉 耎	月 耎
蜺	虫 兒
蜺	蟲 兒	虫 兒
觬	角 兒
貎	豸 兒
輗	車 兒
霓	雨 兒
鲵	鱼 兒
鯢	魚 兒
麑	鹿 兒
齯	齒 兒
臡	難 肉
伱	人 尒	亻 尒
你	人 尔	亻 尔
拟	手 以	扌 以	才 以
抳	手 尼	扌 尼	才 尼
狔	犬 尼	犭 尼
苨	草 尼	艸 尼	艹 尼
柅	木 尼
旎	方 丿 一 尼
晲	日 兒
孴	孨 日
鈮	金 尼	釒 尼
馜	香 尼
儗	人 疑	亻 疑
儞	人 爾	亻 爾
隬	阜 爾	阝 爾
擬	手 疑	扌 疑	才 疑
薿	草 疑	艸 疑	艹 疑
檷	木 爾
聻	漸 耳
屰	丷 一 山	丷 一 屮
氼	水 人
伲	人 尼	亻 尼
迡	辵 尼	辶 尼
昵	日 尼
胒	肉 尼	月 尼
逆	辵 屰	辶 屰
匿	匚 若	匚 若
眤	目 尼
堄	土 兒
惄	叔 心
嫟	女 匿
愵	心 弱	忄 弱
溺	水 弱	氵 弱
睨	目 兒
腻	肉 贰	月 贰
暱	日 匿
縌	絲 逆	糹 逆	糸 逆
誽	言 兒	訁 兒
膩	肉 貳	月 貳
嬺	女 慝
拈	手 占	扌 占	才 占
蔫	草 焉	艸 焉	艹 焉
年	丿 丰 丶	丿 一 二 丶 丨
秊	禾 千
秥	禾 占
鲇	鱼 占
鮎	魚 占
鲶	鱼 念
黏	黍 占
鯰	魚 念
涊	水 忍	氵 忍
捻	手 念	扌 念	才 念
淰	水 念	氵 念
跈	足 人 彡
辇	夫 夫 车
辗	车 展
撚	手 然	扌 然	才 然
撵	手 辇	扌 辇	才 辇
碾	石 展
輦	夫 夫 車
簐	竹 軟
蹍	足 展
攆	手 輦	扌 輦	才 輦
蹨	足 然
躎	足 爾
卄	十 丨	一 丨 丨
廿	一 凵
念	今 心
姩	女 年
唸	口 念
埝	土 念
艌	舟 念
娘	女 良
嬢	女 六 井 一 衣
孃	女 襄
酿	酉 良
醸	酉 六 井 一 衣
釀	酉 襄
鸟	勹 丶 乛 一
茑	草 鸟	艸 鸟	艹 鸟
袅	勹 丶 丨 乛 衣
鳥	户 一 一 乛 火	户 一 一 乛 灬
嫋	女 弱
裊	户 一 一 乛 衣
蔦	草 鳥	艸 鳥	艹 鳥
樢	木 鳥
嬝	女 裊
褭	衣 馬
嬲	男 女 男
尿	尸 水
脲	肉 尿	月 尿
捏	手 圼	扌 圼	才 圼
揑	手 臼 工	扌 臼 工	才 臼 工
苶	草 尒	艸 尒	艹 尒
帇	彐 巾
圼	日 土
枿	木 卉
陧	阜 圼	阝 圼
涅	水 圼	氵 圼
痆	病 尼	疒 尼
聂	耳 又 又
臬	自 木
啮	口 齿
惗	心 念	忄 念
菍	草 念	艸 念	艹 念
隉	阜 臼 土	阝 臼 土
喦	品 山
敜	念 攴	念 攵
湼	水 臼 工	氵 臼 工
嗫	口 聂
嵲	山 臬
踂	足 耴
噛	口 歯
摰	埶 手
槷	埶 木
踗	足 念
踙	足 取
镊	金 聂	钅 聂
镍	金 臬	钅 臬
嶭	山 戶 乛 一 辛	山 户 乛 一 辛
篞	竹 涅	竹 水 日 工	竹 氵 日 工
臲	臬 危
錜	金 念	釒 念
颞	聂 页
蹑	足 聂
嚙	口 齒
聶	耳 耳 耳
鎳	金 臬	釒 臬
闑	門 臬
孼	辥 子
孽	薛 子
櫱	辥 木
籋	竹 爾
蘖	草 檗	艸 檗	艹 檗	薛 木
囁	口 聶
齧	丰 刀 齒
糱	辥 米
糵	薛 米
蠥	辥 虫
蠥	辥 蟲	辥 虫
鑈	金 爾	釒 爾
囓	口 齧	口 丰 刀 齒
讘	言 聶	訁 聶
躡	足 聶
鑷	金 聶	釒 聶
顳	聶 頁
钀	金 獻	釒 獻
囜	囗 厶
您	你 心
拰	手 任	扌 任	才 任
宁	宀 丁
咛	口 宁
拧	手 宁	扌 宁	才 宁
狞	犬 宁	犭 宁
苧	草 宁	艸 宁	艹 宁
柠	木 宁
聍	耳 宁
寍	宀 心 皿
寕	宀 一 丶 目 丁	宀 一 丶 罒 丁
甯	宀 心 用
寗	宓 冉
寗	宓 冉	宀 必 冉
寜	宀 心 皿 亅
寧	宀 心 皿 丁
儜	人 寧	亻 寧
凝	冰 疑	冫 疑
嚀	口 寧
嬣	女 寧
擰	手 寧	扌 寧	才 寧
獰	犬 寧	犭 寧
薴	草 寧	艸 寧	艹 寧
檸	木 寧
聹	耳 寧
鑏	金 寧	釒 寧
鬡	髟 寧
鸋	寧 鳥
橣	木 甯
矃	目 寧
佞	人 二 女	亻 二 女
侫	人 忘	亻 忘
泞	水 宁	氵 宁
濘	水 寧	氵 寧
妞	女 丑
牛	丿 一 十
牜	丿 十 丿
忸	心 丑	忄 丑
扭	手 丑	扌 丑	才 丑
狃	犬 丑	犭 丑
纽	丝 丑	纟 丑
炄	火 丑
钮	金 丑	钅 丑
紐	絲 丑	糹 丑	糸 丑
莥	草 狃	艸 狃	艹 狃
鈕	金 丑	釒 丑
靵	革 丑
农	冖 衣
侬	人 农	亻 农
哝	口 农
浓	水 农 脓	氵 农 脓
脓	肉 农	月 农
秾	禾 农
農	曲 辰
儂	人 農	亻 農
辳	林 辰
噥	口 農
濃	水 農 膿	氵 農 膿
蕽	草 農	艸 農	艹 農
檂	木 農
燶	火 農
禯	示 農	礻 農
膿	肉 農	月 農
穠	禾 農
襛	衣 農	衤 農
醲	酉 農
欁	林 農	木 農 木
繷	絲 農	糹 農	糸 農
弄	王 廾
挊	手 上 下	扌 上 下	才 上 下
挵	手 弄	扌 弄	才 弄
癑	病 農	疒 農
齈	鼻 農
羺	羊 需
啂	口 乳
槈	木 辱
耨	耒 辱
獳	犬 需	犭 需
檽	木 需
鎒	金 辱	釒 辱
鐞	金 尋	釒 尋
譳	言 需	訁 需
奴	女 又
孥	奴 子
驽	奴 马
笯	竹 奴
駑	奴 馬
伮	人 奴	亻 奴
努	奴 力
弩	奴 弓
砮	奴 石
胬	奴 肉	奴 月
怒	奴 心
傉	人 辱	亻 辱
搙	手 辱	扌 辱	才 辱
女	𠃊 一 丿
钕	金 女	钅 女
籹	米 女
釹	金 女	釒 女
沑	水 丑	氵 丑
衂	血 刄
恧	而 心
朒	月 肉
衄	血 丑
奻	女 女
渜	水 耎	氵 耎
暖	日 爰
煖	火 爰
煗	火 耎
餪	食 耎
疟	病 匚 一	疒 匚 一
虐	虎 匚 一	虍 匚 一
硸	石 岸
瘧	病 虐	疒 虐
黁	麻 香
郍	舟 邑	舟 阝
挪	手 那	扌 那	才 那
梛	木 那
傩	人 难	亻 难
儺	人 難	亻 難
橠	木 袲
诺	言 若	讠 若
喏	口 若
掿	手 若	扌 若	才 若
逽	辵 若	辶 若
愞	心 耎	忄 耎
搦	手 弱	扌 弱	才 弱
锘	金 若	钅 若
搻	合 手 手
榒	木 弱
稬	禾 耎
諾	言 若	訁 若
蹃	足 若
糑	米 弱
懦	心 需	忄 需
懧	心 寧	忄 寧
糥	米 需
穤	禾 需
糯	米 需
喔	口 屋
噢	口 奥
哦	口 我
讴	言 区	讠 区
沤	水 区	氵 区
欧	区 欠
殴	区 殳
瓯	区 瓦
鸥	区 鸟
塸	土 區
漚	水 區	氵 區
歐	區 欠
毆	區 殳
熰	火 區
甌	區 瓦
鴎	区 鳥
櫙	木 區
謳	言 區	訁 區
鏂	金 區	釒 區
鷗	區 鳥
齵	齒 禺
吘	口 午
呕	口 区
偶	人 禺	亻 禺
腢	肉 禺	月 禺
嘔	口 區
耦	耒 禺
蕅	草 湡	艸 湡	艹 湡
藕	草 耦	艸 耦	艹 耦
怄	心 区	忄 区
慪	心 區	忄 區
妑	女 巴
皅	白 巴
趴	足 八
舥	舟 巴
啪	口 拍
葩	草 皅	艸 皅	艹 皅
杷	木 巴
爬	爪 巴
掱	手 手 手
琶	玉 巴	王 巴
筢	竹 把
潖	水 琶	氵 琶
帊	巾 巴
帕	巾 白
怕	心 白	忄 白
袙	衣 白	衤 白
拍	手 白	扌 白	才 白
俳	人 非	亻 非
徘	彳 非
排	手 非	扌 非	才 非
猅	犬 非	犭 非
棑	木 非
牌	片 卑
輫	車 非
簰	竹 牌
簲	竹 脾
犤	牛 罷	牜 罷
廹	廴 白
哌	口 厂 氏
哌	口 厂 氏	口 𠂢
派	水 厂 氏	氵 厂 氏	水 𠂢	氵 𠂢
渒	水 卑	氵 卑
湃	水 拜	氵 拜
蒎	草 派	艸 派	艹 派
鎃	金 派	釒 派
眅	目 反
畨	米 田
萠	草 朋	艸 朋	艹 朋
潘	水 番	氵 番
攀	棥 大 手	林 爻 大 手	木 木 乂 乂 大 手
爿	丨 一 丨 一 丿 
洀	水 舟	氵 舟
盘	舟 皿
跘	足 半
媻	般 女
幋	般 巾
蒰	草 般	艸 般	艹 般
搫	般 手
槃	般 木
盤	般 皿
磐	般 石
縏	般 糸
磻	石 番
瀊	水 盤	氵 盤
蟠	虫 番
蟠	蟲 番	虫 番
蹣	足 廿 冂 丨 入 入	足 㒼
鎜	般 金
鞶	般 革
冸	冰 半	冫 半
判	半 刀	半 刂
沜	水 片	氵 片
拚	手 厶 廾	扌 厶 廾	才 厶 廾
泮	水 半	氵 半
炍	火 反
叛	半 反
牉	片 半
盼	目 分
畔	田 半
袢	衣 半	衤 半
詊	言 半	訁 半
溿	水 畔	氵 畔
頖	半 頁
鋬	扳 金
襻	衣 攀	衤 攀
鑻	金 攀	釒 攀
乓	丘 丶
沗	天 水
胮	肉 夅	月 夅
雱	雨 方
滂	水 旁	氵 旁
膖	肉 逢	月 逢
霶	雨 滂
厐	厂 龙
庞	广 龙
厖	厂 尨
逄	辵 夅	辶 夅
旁	亠 丷 冖 方
舽	舟 夅
嫎	女 旁
徬	彳 旁
螃	虫 旁
螃	蟲 旁	虫 旁
鳑	鱼 旁
龎	厂 龍
龐	广 龍
嗙	口 旁
耪	耒 旁
覫	旁 見
炐	火 丰
肨	肉 丰	月 丰
胖	肉 半	月 半
抛	手 尢 力	扌 尢 力	才 尢 力
拋	手 尢 力	扌 尢 力	才 尢 力
脬	肉 孚	月 孚
刨	包 刀	包 刂
咆	口 包
垉	土 包
庖	广 包
狍	犬 包	犭 包
炰	包 火	包 灬
爮	爪 包
袍	衣 包	衤 包
匏	夸 包
軳	車 包
鞄	革 包
麃	鹿 火	鹿 灬
麅	鹿 包
跑	足 包
奅	大 卯
泡	水 包	氵 包
炮	火 包
疱	病 包	疒 包
皰	皮 包
砲	石 包
麭	麥 包
礟	石 駁
礮	石 馬 交
呸	口 丕	口 不 一
怌	心 丕	忄 丕
肧	肉 不	月 不
柸	木 丕
胚	肉 丕	月 丕
衃	血 不
醅	酉 咅
阫	阜 不	阝 不
陪	阜 咅	阝 咅
培	土 咅
毰	毛 咅
赔	贝 咅
锫	金 咅	钅 咅
裴	非 衣
裵	衣 非
賠	貝 咅
駍	馬 平
俖	人 否	亻 否
伂	人 巿	亻 巿
沛	水 巿	氵 巿
佩	人 几 帀	亻 几 帀
帔	巾 皮
姵	女 几 帀
斾	方 丿 一 巾
旆	方 丿 一 巿
浿	水 貝	氵 貝
珮	玉 几 帀
配	酉 己
辔	丝 车 口
馷	馬 巿
嶏	山 厂 配
霈	雨 沛
轡	絲 車 口
喷	口 贲
噴	口 賁
歕	賁 欠
瓫	分 瓦
盆	分 皿
湓	水 盆	氵 盆
葐	草 盆	艸 盆	艹 盆	芬 皿
呠	口 本
翸	賁 羽
喯	口 奔
匉	勹 平
怦	心 平	忄 平
抨	手 平	扌 平	才 平
恲	心 并	忄 并
恲	心 并	忄 并	心 幷	忄 幷
砰	石 平
梈	木 亨
烹	亨 火	亨 灬
硑	石 并
硑	石 并	石 幷
軯	車 平
閛	門 平
漰	水 崩	氵 崩
嘭	口 彭
澎	水 彭	氵 彭
磞	石 崩
芃	草 凡	艸 凡	艹 凡
朋	月 月
挷	手 邦	扌 邦	才 邦
竼	竹 凡
倗	人 朋	亻 朋
莑	草 夆	艸 夆	艹 夆
堋	土 朋
弸	弓 朋
彭	壴 彡
棚	木 朋
椖	木 房
塳	土 逢
硼	石 朋
稝	禾 朋
蓬	草 逢	艸 逢	艹 逢
鹏	朋 鸟
槰	木 逢
樥	木 莑
熢	火 逢
憉	心 彭	忄 彭
輣	車 朋
篣	竹 旁
篷	竹 逢
膨	肉 彭	月 彭
錋	金 朋	釒 朋
韸	音 夆
髼	髟 夆
蟚	彭 虫
蟚	彭 蟲	彭 虫
蟛	虫 彭
蟛	蟲 彭	虫 彭
鬅	髟 朋
纄	絲 蓬	糹 蓬	糸 蓬
韼	音 逢
鵬	朋 鳥
騯	馬 旁
鬔	髟 逢
鑝	金 蓬	釒 蓬
捧	手 奉	扌 奉	才 奉
淎	水 奉	氵 奉
皏	白 并	白 幷
剻	崩 刀	崩 刂
掽	手 並	扌 並	才 並
椪	木 並
碰	石 並
踫	足 並
丕	不 一
伓	人 不	亻 不
伾	人 丕	亻 丕
批	手 比	扌 比	才 比
纰	丝 比	纟 比
邳	丕 邑	丕 阝
坯	土 丕
披	手 皮	扌 皮	才 皮
抷	手 丕	扌 丕	才 丕
炋	火 不
狉	犬 丕	犭 丕
砒	石 比
悂	心 坒	忄 坒
秛	禾 皮
秠	禾 丕
紕	絲 比	糹 比	糸 比
铍	金 皮	钅 皮
旇	方 丿 一 皮
翍	羽 皮
耚	耒 皮
豾	豸 丕
鈈	金 不	釒 不
鈚	金 比	釒 比
鈹	金 皮	釒 皮
鉟	金 丕	釒 丕
銔	金 不 十	釒 不 十
劈	辟 刀
磇	石 囟 比
駓	馬 丕
髬	髟 丕
噼	口 辟
錃	波 金
錍	金 卑	釒 卑
魾	魚 丕
鮍	魚 皮
憵	辟 心
礔	石 辟
礕	辟 石
霹	雨 辟
皮	乛 丿 丨 又	丿 支
阰	阜 比	阝 比
芘	草 比	艸 比	艹 比
岯	山 丕
枇	木 比
毞	比 毛
狓	犬 皮	犭 皮
肶	肉 比	月 比
毗	田 比
毘	田 比
疲	病 皮	疒 皮
蚍	虫 比
蚍	蟲 比	虫 比
郫	卑 邑	卑 阝
陴	阜 卑	阝 卑
啤	口 卑
埤	土 卑
崥	山 卑
蚽	虫 丕
蚽	蟲 丕	虫 丕
蚾	虫 皮
蚾	蟲 皮	虫 皮
豼	豸 比
焷	火 卑
琵	玉 比	王 比
脾	肉 卑	月 卑
腗	肉 畁	月 畁
鲏	鱼 皮
罴	罢 火	罢 灬
膍	肉 囟 比	月 囟 比
蜱	虫 卑
蜱	蟲 卑	虫 卑
魮	魚 比
壀	土 辟
篺	竹 捭
螷	庳 虫
螷	庳 蟲	庳 虫
貔	豸 囟 比
鵧	并 鳥	幷 鳥
羆	网 熊	罒 熊	罷 火	罷 灬
朇	會 卑
鼙	鼓 卑
蠯	广 卑 虫 虫
蠯	广 卑 蟲 蟲	广 卑 虫 虫
匹	匚 儿	匚 儿
庀	广 匕
疋	乛 卜 人
仳	人 比	亻 比
圮	土 己
苉	草 匹	艸 匹	艹 匹
脴	肉 否	月 否
痞	病 否	疒 否
銢	金 二 水	釒 二 水
諀	言 卑	訁 卑
鴄	匹 鳥
擗	手 辟	扌 辟	才 辟
噽	喜 丕
癖	病 辟	疒 辟
嚭	喜 否
屁	尸 比
淠	水 畀	氵 畀
揊	手 畐	扌 畐	才 畐
釽	金 爪	釒 爪
媲	女 囟 比
嫓	女 刀 内 比
睥	目 卑
辟	尸 口 辛
潎	水 敝	氵 敝
稫	禾 畐
僻	人 辟	亻 辟
澼	水 辟	氵 辟
嚊	口 鼻
甓	辟 瓦
疈	畐 丶 丿 畐
譬	辟 言
闢	門 辟
鷿	辟 鳥
鸊	辟 鳥
囨	囗 不
偏	人 扁	亻 扁
媥	女 扁
犏	牛 扁	牜 扁
篇	竹 扁
翩	扁 羽
鍂	金 金
鶣	扁 鳥
骈	马 并
胼	肉 并	月 并
谝	言 扁	讠 扁
腁	肉 幷	月 幷
楄	木 扁
楩	木 便
賆	貝 并	貝 幷
跰	足 并
跰	足 并	足 幷
諚	言 定	訁 定
骿	骨 并
骿	骨 并	骨 幷
蹁	足 扁
駢	馬 并	馬 幷
騈	馬 幷
覑	片 見
貵	厶 大 貝
諞	言 扁	訁 扁
片	丄 丿 乛
骗	马 扁
騗	扁 馬
騙	馬 扁
剽	票 刀	票 刂
彯	票 彡
慓	心 票	忄 票
缥	丝 票	纟 票
飘	票 风
旚	方 丿 一 票
翲	票 羽
螵	虫 票
螵	蟲 票	虫 票
犥	牛 麃	牜 麃
飃	風 票
飄	票 風
魒	鬼 票
嫖	女 票
瓢	票 瓜
薸	草 漂	艸 漂	艹 漂
闝	門 敗
殍	歹 孚
瞟	目 票
篻	竹 票
縹	絲 票	糹 票	糸 票
醥	酉 票
皫	白 麃
顠	票 頁
票	西 示	襾 示	覀 示
僄	人 票	亻 票
勡	票 力
嘌	口 票
徱	彳 票
漂	水 票	氵 票
氕	气 丿
氕	氣 丿	气 丿
撇	手 敝	扌 敝	才 敝
撆	敝 手
暼	敝 日
瞥	敝 目
苤	草 丕	艸 丕	艹 丕
鐅	敝 金
嫳	敝 女
姘	女 并
姘	女 并	女 幷
拼	手 并	扌 并	才 并
拼	手 并	扌 并	才 并	手 幷	扌 幷	才 幷
礗	石 賓
馪	香 賓
驞	馬 賓
玭	玉 比	王 比
贫	分 贝
娦	女 兵
貧	分 貝
琕	玉 卑	王 卑
嫔	女 宾
频	步 页
頻	步 頁
嬪	女 賓
薲	草 賓	艸 賓	艹 賓
嚬	口 頻
矉	目 賓
蠙	蟲 賓	虫 賓
颦	频 卑
顰	頻 卑
品	口 口 口
榀	木 品
牝	牛 匕	牜 匕
汖	山 水
聘	耳 甹	耳 由 丂
乒	丘 丿
甹	由 亏	由 丂
俜	人 甹	亻 甹
娉	女 甹
涄	水 甹	氵 甹
砯	石 氷
聠	耳 并
聠	耳 并	耳 幷
艵	并 色
艵	并 色	幷 色
竮	立 屏
頩	并 頁	幷 頁
平	干 丷
评	言 平	讠 平
凭	任 几
呯	口 平
坪	土 平
泙	水 平	氵 平
苹	草 平	艸 平	艹 平
郱	并 邑	并 阝
郱	并 邑	并 阝	幷 邑	幷 阝
屏	尸 并
屏	尸 并	尸 幷
帡	巾 并
枰	木 平
洴	水 并	氵 并
洴	水 并	氵 并	水 幷	氵 幷
玶	玉 平	王 平
胓	肉 平	月 平
荓	草 并	艸 并	艹 并
荓	草 并	艸 并	艹 并	草 幷	艸 幷	艹 幷
瓶	并 瓦
瓶	并 瓦	幷 瓦
屛	尸 幷
帲	巾 幷
淜	水 朋	氵 朋
萍	草 水 平	艸 氵 平	艹 氵 平
蚲	虫 平
蚲	蟲 平	虫 平
幈	巾 屏
焩	火 朋
甁	幷 瓦
缾	缶 并
缾	缶 并	缶 幷
蓱	草 洴	艸 洴	艹 洴
蛢	虫 并
蛢	蟲 并	虫 并	蟲 幷	虫 幷
評	言 平	訁 平
軿	車 并	車 幷
鲆	鱼 平
凴	馮 几
箳	竹 屏
輧	車 幷
憑	馮 心
鮃	魚 平
檘	木 辟
簈	竹 幷
蘋	草 頻	艸 頻	艹 頻
钋	金 卜	钅 卜
坡	土 皮
岥	山 皮
泊	水 白	氵 白
泼	水 发	氵 发
溌	水 発	氵 発
鉕	金 叵	釒 叵
頗	皮 頁
潑	水 發	氵 發
鏺	金 發	釒 發
婆	波 女
嘙	口 婆
蔢	草 婆	艸 婆	艹 婆
鄱	番 邑	番 阝
皤	白 番
謈	日 共 言
櫇	木 頗
叵	匚 口
尀	叵 寸
钷	金 叵	钅 叵
笸	竹 叵
颇	皮 页
駊	馬 皮
岶	山 白
迫	辵 白	辶 白
敀	白 攴	白 攵
昢	日 出
洦	水 百	氵 百
珀	玉 白	王 白
烞	火 朴
破	石 皮
砶	石 白
釙	金 卜	釒 卜
粕	米 白
酦	酉 发
蒪	草 尃	艸 尃	艹 尃
魄	白 鬼
醗	酉 発
桲	木 孛
剖	咅 刀	咅 刂	立 口 刀	立 口 刂
娝	女 否
抔	手 不	扌 不	才 不
抙	手 手	扌 手
捊	手 孚	扌 孚	才 孚
掊	手 咅	扌 咅	才 咅
裒	衣 臼
箁	竹 咅
錇	金 咅	釒 咅
咅	立 口
哣	口 豆
婄	女 咅
犃	牛 咅	牜 咅
仆	人 卜	亻 卜
攴	卜 又
攵	丿 一 乂
扑	手 卜	扌 卜	才 卜
炇	火 攴	火 攵
陠	阜 甫	阝 甫
噗	口 菐
撲	手 菐	扌 菐	才 菐
潽	水 普	氵 普
擈	手 業	扌 業	才 業
鯆	魚 甫
圤	土 卜
匍	勹 甫
莆	草 甫	艸 甫	艹 甫
脯	肉 甫	月 甫
菩	草 咅	艸 咅	艹 咅
菐	业 丷 三 人
葡	草 匍	艸 匍	艹 匍
蒱	草 捕	艸 捕	艹 捕
蒲	草 浦	艸 浦	艹 浦
僕	人 菐	亻 菐
酺	酉 甫
墣	土 菐
獛	犬 菐	犭 菐
璞	玉 菐	王 菐
濮	水 僕	氵 僕
瞨	目 菐
穙	禾 菐
镤	金 菐	钅 菐
纀	絲 僕	糹 僕	糸 僕
鏷	金 菐	釒 菐
朴	木 卜
圃	囗 甫
浦	水 甫	氵 甫
烳	火 甫
普	並 日	丷 晋
圑	囗 尃
溥	水 尃	氵 尃
暜	立 立 日
谱	言 普	讠 普
諩	言 並	訁 並
樸	木 菐
氆	毛 普
檏	木 業
镨	金 普	钅 普
譜	言 普	訁 普
蹼	足 菐
鐠	金 普	釒 普
铺	金 甫	钅 甫
铺	金 金 甫	钅 钅 甫
舖	舍 甫
舗	人 土 口 甫	舍 甫
鋪	金 甫	釒 甫
瀑	水 暴	氵 暴
曝	日 暴
巭	功 夫
七	一 乚	丿 乚
迉	辵 尸	辶 尸
沏	水 切	氵 切
妻	一 聿 女	一 肀 女
柒	水 七 木
柒	氵 七 木
倛	人 其	亻 其
凄	冰 妻	冫 妻
栖	木 西
桤	木 岂
郪	妻 邑	妻 阝
娸	女 其
悽	心 妻	忄 妻
戚	厂 上 小 戈	丿 上 小 戈
捿	手 妻	扌 妻	才 妻
桼	木 水
淒	水 妻	氵 妻
萋	草 妻	艸 妻	艹 妻
攲	奇 支
期	其 月
棲	木 妻
欺	其 欠
紪	絲 此	糹 此	糸 此
蛣	虫 吉
蛣	蟲 吉	虫 吉
僛	人 欺	亻 欺
嘁	口 戚
慽	心 戚	忄 戚
榿	木 豈
漆	水 桼	氵 桼
緀	絲 妻	糹 妻	糸 妻
慼	戚 心
槭	木 戚
諆	言 其	訁 其
諿	言 咠	訁 咠
霋	雨 妻
蹊	足 奚
魌	鬼 其
鏚	金 戚	釒 戚
鶈	妻 鳥
亓	一 丌
祁	示 邑	礻 阝
齐	文 丿 丨
圻	土 斤
岐	山 支
岓	山 斤
忯	心 氐	忄 氐
芪	草 氏	艸 氏	艹 氏
亝	厽 二
其	甘 一 八
奇	大 可
斉	文 丿 二 丨
歧	止 支
祇	示 氏	礻 氏
祈	示 斤	礻 斤
肵	肉 斤	月 斤
俟	人 矣	亻 矣
疧	病 氏	疒 氏
竒	立 口 亅	亠 丷 可
剘	其 刀	其 刂
斊	文 耳
旂	方 丿 一 斤
耆	老 日
脐	肉 齐	月 齐
蚑	虫 支
蚑	蟲 支	虫 支
蚔	虫 氏
蚔	蟲 氏	虫 氏
蚚	虫 斤
蚚	蟲 斤	虫 斤
颀	斤 页
埼	土 奇
崎	山 奇
帺	巾 其
掑	手 其	扌 其	才 其
淇	水 其	氵 其
猉	犬 其	犭 其
畦	田 圭	田 土 土
萁	草 其	艸 其	艹 其
萕	草 斉	艸 斉	艹 斉
跂	足 支
軝	車 氏
釮	金 才	釒 才
骐	马 其
骑	马 奇
棊	其 木
棋	木 其
琦	玉 奇	王 奇
琪	玉 其	王 其
祺	示 其	礻 其
蛴	虫 齐
愭	心 耆	忄 耆
碁	其 石
碕	石 奇
褀	衣 其	衤 其
锜	金 奇	钅 奇
頎	斤 頁
鬿	鬼 斤
旗	方 丿 一 其
粸	米 其
綥	絲 畀	糹 畀	糸 畀
綦	其 糸
綨	絲 其	糹 其	糸 其
蜝	其 虫
蜝	其 蟲	其 虫
蜞	虫 其
蜞	蟲 其	虫 其
齊	亠 刀 丫 丿 𠄌 乁 丿 丨 二
璂	玉 基	王 基
禥	示 基	礻 基
蕲	草 单 斤	艸 单 斤	艹 单 斤
踑	足 其
錡	金 奇	釒 奇
鲯	鱼 其
懠	心 齊	忄 齊
濝	水 綦	氵 綦
藄	草 綦	艸 綦	艹 綦
檱	木 箕
櫀	木 綦
臍	肉 齊	月 齊
騎	馬 奇
騏	馬 其
鳍	鱼 耆
蘄	草 單 斤	艸 單 斤	艹 單 斤
鯕	魚 其
鵸	奇 鳥
鶀	鳥 其
麒	鹿 其
纃	絲 齊	糹 齊	糸 齊
艩	舟 齊
蠐	蟲 齊	虫 齊
鬐	髟 耆
騹	馬 堇
鰭	魚 耆
玂	犬 蕇 斤	犭 蕇 斤	犬 蘄	犭 蘄
麡	鹿 齊
乞	丿 一 乙
邔	己 邑	己 阝
企	人 止
屺	山 己
岂	山 己
芑	草 己	艸 己	艹 己
启	户 口
呇	水 口
杞	木 己
玘	玉 己	王 己
盀	卜 皿
唘	石 又 口
豈	山 豆
起	走 己
啓	戶 攴 口	戶 攵 口
啔	戶 戈 口	户 戈 口
婍	女 奇
啟	戶 口 攴	戶 口 攵
绮	丝 奇	纟 奇
晵	戶 攵 日
晵	户 攵
棨	戶 攵 木
棨	户 攵
綮	戶 攵 糸	户 攵 糸
綺	絲 奇	糹 奇	糸 奇
諬	禾 尤 言
闙	門 啟
气	乞 一	丿 一 一 乙
讫	言 乞	讠 乞
忔	心 乞	忄 乞
気	氣 乂	气 乂
汔	水 乞	氵 乞
迄	辵 乞	辶 乞
弃	亠 厶 廾
汽	水 气	氵 气
汽	水 氣	氵 气
矵	石 刀	石 刂
芞	草 气	艸 气	艹 气
呮	口 只
泣	水 立	氵 立
炁	旡 火	旡 灬
盵	目 乞
咠	口 耳
契	丰 刀 大
砌	石 切
栔	丰 刀 木 
氣	气 米
訖	言 乞	訁 乞
唭	口 其
欫	午 止 欠
夡	多 吉
棄	亠 厶 廿 木
湆	水 音	氵 音
湇	水 立 肉	氵 立 肉	水 立 月	氵 立 月
葺	草 咠	艸 咠	艹 咠	草 口 耳
碛	石 责
摖	手 祭	扌 祭	才 祭
暣	日 氣
甈	臬 瓦
碶	石 契
噐	口 口 工 口 口
憇	甜 心
器	口 口 大 口 口
憩	舌 自 心
磜	石 祭
磧	石 責
磩	石 戚
罊	車 凵 殳 缶
蟿	車 凵 殳 蟲	車 凵 殳 虫
鼜	鼓 蚤
掐	手 臽	扌 臽	才 臽
袷	衣 合	衤 合
葜	草 契	艸 契	艹 契
拤	手 卡
峠	山 上 下
跒	足 可
酠	酉 可
圶	大 土
冾	冰 合	冫 合
帢	巾 合
恰	心 合	忄 合
洽	水 合	氵 合
殎	歹 夾
硈	石 吉
愘	心 客	忄 客
髂	骨 客
千	丿 十
仟	人 千	亻 千
阡	阜 千	阝 千
圱	千 土
圲	土 千
奷	女 千
扦	手 千	扌 千	才 千
汘	水 千	氵 千
芊	草 千	艸 千	艹 千
迁	辵 千	辶 千
佥	人 一 小 一
岍	山 开
杄	木 千
汧	水 开	氵 开
欦	今 欠
臤	臣 又
钎	金 千	钅 千
拪	手 西	扌 西	才 西
牵	大 冖 牛
粁	米 千
兛	克 千
悭	心 坚	忄 坚
蚈	虫 开
蚈	蟲 开	虫 开
谸	千 谷
铅	金 几 口	钅 几 口
婜	臣 又 女
孯	臣 又 子
牽	玄 冖 牛
釺	金 千	釒 千
掔	臣 又 手
谦	言 兼	讠 兼
鈆	金 公	釒 公
雃	开 隹
僉	人 一 口 口 人 人
愆	衍 心
签	竹 佥
鉛	金 八 口	釒 八 口
骞	马 宀 井 大
鹐	臽 鸟
慳	心 堅	忄 堅
搴	宀 井 大 手
撁	手 牽	扌 牽	才 牽
箞	竹 卷
諐	侃 言
遷	辵 西 大 己	辶 覀 大 己
褰	宀 井 大 衣
謙	言 兼	訁 兼
顅	肩 頁
檶	木 奩
攐	手 褰	扌 褰	才 褰
攑	手 舉	扌 舉	才 舉
櫏	木 遷
簽	竹 僉
鵮	臽 鳥
孅	女 韱
攓	手 蹇	扌 蹇	才 蹇
騫	馬 宀 井 大
鬝	髟 間
鬜	髟 閒
籤	竹 韱	竹 人 人 戈 韭
韆	革 遷
仱	人 今	亻 今
岒	山 今
忴	心 今	忄 今
扲	手 今	扌 今	才 今
拑	手 甘	扌 甘	才 甘
前	丷 一 肉 刀	丷 一 月 刂
钤	金 今	钅 今
歬	止 舟
虔	虎 文	虍 文
钱	金 戋	钅 戋
钳	金 甘	钅 甘
乾	十 日 十 乞
偂	人 前	亻 前
掮	手 肩	扌 肩	才 肩
揵	手 建	扌 建	才 建
軡	車 今
媊	女 前
鈐	金 今	釒 今
靬	革 干
鉗	金 甘	釒 甘
墘	土 乾
榩	木 虔
箝	竹 拑
銭	金 一 戋	釒 一 戋
潛	水 朁	氵 朁
潜	水 替	氵 替
羬	羊 咸
蕁	草 尋	艸 尋	艹 尋
橬	木 朁
錢	金 戔	釒 戔
黔	黑 今
黚	黑 甘
騝	馬 建
濳	水 先 先 曰	氵 先 先 曰	水 先 先 日	氵 先 先 日
騚	馬 前
灊	水 鬵	氵 鬵
鰬	魚 虔
凵	丨 一 丨
浅	水 戋	氵 戋
肷	肉 欠	月 欠
淺	水 戔	氵 戔
脥	肉 夾	月 夾
嗛	口 兼
嵰	山 兼
遣	辵 中 一 尸 乛 一	辶 辵 中 一 尸 乛 一
槏	木 兼
膁	肉 兼	月 兼
蜸	臣 又 蟲	臣 又 虫
谴	言 遣	讠 遣
缱	丝 遣	纟 遣
繾	絲 遣	糹 遣	糸 遣
譴	言 遣	訁 遣
欠	刀 人
刋	千 刀	千 刂
芡	草 欠	艸 欠	艹 欠
俔	人 見	亻 見
茜	草 西	艸 西	艹 西
倩	人 青	亻 青
悓	心 見	忄 見
堑	斩 土
傔	人 丶 丶 兼	亻 丶 丶 兼
嵌	山 甘 欠
棈	木 青
椠	木 斩
慊	心 丶 丶 兼	忄 丶 丶 兼
皘	白 青
蒨	草 倩	艸 倩	艹 倩
塹	斬 土
歉	兼 欠
綪	絲 青	糹 青	糸 青
蔳	草 清	艸 清	艹 清
儙	人 遣	亻 遣
槧	木 斬
篏	竹 甘 欠
輤	車 青
篟	竹 倩
壍	漸 土
嬱	漸 女
縴	絲 牽	糹 牽	糸 牽
鰜	魚 兼
呛	口 仓
羌	羊 儿
戕	爿 戈
戗	仓 戈
斨	爿 斤
枪	木 仓
玱	玉 仓	王 仓
羗	羌 厶
猐	犬 羌	犭 羌
跄	足 仓
椌	木 空
溬	水 羗	氵 羗
腔	肉 空	月 空
嗆	口 倉
蜣	虫 羌
蜣	蟲 羌	虫 羌
锖	金 青	钅 青
嶈	山 將
戧	倉 戈
槍	木 倉
牄	爿 倉
瑲	玉 倉	王 倉
羫	羊 空
锵	金 将	钅 将
篬	竹 倉
錆	金 青	釒 青
謒	言 倉	訁 倉
蹌	足 倉
镪	金 强	钅 强
蹡	足 將
鎗	金 倉	釒 倉
鏘	金 將	釒 將
丬	冫 丨
強	弓 厶 蟲	弓 厶 虫
强	弓 虽
墙	土 啬
嫱	女 啬
蔷	草 啬	艸 啬	艹 啬
樯	木 啬
漒	水 強	氵 強
漒	水 强	氵 强
蔃	草 强	艸 强	艹 强
墻	土 嗇
嬙	女 嗇
廧	广 嗇
薔	草 嗇	艸 嗇	艹 嗇
檣	木 嗇
牆	爿 嗇
艢	舟 嗇
蘠	草 牆	艸 牆	艹 牆
抢	手 仓	扌 仓	才 仓
羟	羊 𢀖
搶	手 倉	扌 倉	才 倉
羥	羊 巠
墏	將 土
繈	絲 強	糹 強	糸 強
襁	衣 強	衤 強
繦	絲 强	糹 强	糸 强
鏹	金 強	釒 強
炝	火 仓
唴	口 羌
熗	火 倉
羻	羊 慶
悄	心 肖	忄 肖
硗	石 尧
郻	目 丨 一 巛 邑	目 丨 一 巛 阝
嵪	山 高
跷	足 尧
鄡	梟 邑	梟 阝
鄥	鳥 邑	鳥 阝
劁	焦 刀	焦 刂
敲	高 攴	高 攵
毃	高 殳
踍	足 孝
锹	金 秋	钅 秋
墝	土 堯
頝	交 頁
骹	骨 交
墽	土 敫
幧	巾 喿
橇	木 毳
燆	火 喬
缲	丝 喿	纟 喿
磽	石 堯
鍫	秋 金
鍬	金 秋	釒 秋
繑	絲 喬	糹 喬	糸 喬
趬	走 堯
蹺	足 堯
鐰	金 喿	釒 喿
乔	夭 丿 丨
侨	人 乔	亻 乔
荍	草 收	艸 收	艹 收
荞	草 乔	艸 乔	艹 乔
桥	木 乔
硚	石 乔
菬	草 沼	艸 沼	艹 沼
喬	夭 口 冂 口
僑	人 喬	亻 喬
谯	言 焦	讠 焦
嘺	口 喬
嫶	女 焦
憔	心 焦	忄 焦
蕎	草 喬	艸 喬	艹 喬
鞒	革 乔
樵	木 焦
橋	木 喬
癄	病 焦	疒 焦
瞧	目 焦
礄	石 喬
藮	草 樵	艸 樵	艹 樵
趫	走 喬
鐈	金 喬	釒 喬
鞽	革 喬
顦	焦 頁
巧	工 丂	工 万
釥	金 小	釒 小
愀	心 秋	忄 秋
髜	高 昇
俏	人 肖	亻 肖
诮	言 肖	讠 肖
陗	阜 肖	阝 肖
峭	山 肖
帩	巾 肖
窍	穴 巧
殻	壳 殳
翘	尧 羽
誚	言 肖	訁 肖
髚	高 亢
僺	人 喿	亻 喿
撬	手 毳	扌 毳	才 毳
撽	手 敫	扌 敫	才 敫
鞘	革 肖
韒	韋 肖
竅	穴 敫
翹	堯 羽
鞩	革 削
譙	言 焦	訁 焦
躈	足 敫
癿	白 乙	白 乚
且	月 一
切	七 刀
厒	厂 缶
妾	立 女
怯	心 去	忄 去
郄	乂 厷 邑	乂 厷 阝
匧	匚 夾
窃	穴 切
悏	心 夾	忄 夾
挈	丰 刀 手
洯	水 丰 刀	氵 丰 刀
惬	心 匧	忄 匧
淁	水 妾	氵 妾
笡	竹 且
愜	心 匧	忄 匧
蛪	丰 刀 虫
蛪	丰 刀 蟲	丰 刀 虫
朅	去 曷
箧	竹 匚 夹
緁	絲 疌	糹 疌	糸 疌
锲	金 契	钅 契
篋	竹 匧
踥	足 妾
穕	禾 集
藒	草 禾 曷	艸 禾 曷	艹 禾 曷
鍥	金 契	釒 契
鯜	魚 妾
鐑	金 結	釒 結
竊	穴 釆 禼	穴 采 禼
亲	立 木
侵	人 彐 冖 又	亻 彐 冖 又
钦	金 欠	钅 欠
衾	今 衣
骎	马 彐 冖 又
媇	女 亲
嵚	山 钦
欽	金 欠	釒 欠
綅	絲 彐 冖 又	糹 彐 冖 又	糸 彐 冖 又
誛	言 彐 冖 又	訁 彐 冖 又
嶔	山 欽
親	亲 見	立 木 見
顉	金 頁	釒 頁
駸	馬 彐 冖 又
鮼	魚 彐 冖 又
寴	宀 親
庈	广 今
芩	草 今	艸 今	艹 今
芹	草 斤	艸 斤	艹 斤
埁	土 岑
珡	玉 玉 人	王 王 人
秦	手 乀 禾	𡗗 禾
耹	耳 今
菦	草 近	艸 近	艹 近
蚙	虫 今
蚙	蟲 今	虫 今
捦	手 金	扌 金	才 金
菳	草 金	艸 金	艹 金
琴	玉 玉 今	王 王 今
琹	玉 玉 木	王 王 木
禽	人 离
鈙	金 攴	釒 攴
雂	今 隹
勤	堇 力
嗪	口 秦
嫀	女 秦
溱	水 秦	氵 秦
靲	革 今
慬	心 堇	忄 堇
噙	口 禽
擒	手 禽	扌 禽	才 禽
斳	堇 斤
鳹	今 鳥
懄	心 勤	忄 勤
檎	木 禽
澿	水 禁	氵 禁
瘽	病 堇	疒 堇
螓	虫 秦
螓	蟲 秦	虫 秦
懃	勤 心
蠄	虫 禽
蠄	蟲 禽	虫 禽
鬵	旡 旡 鬲
鵭	金 鳥	釒 鳥
坅	土 今
昑	日 今
笉	竹 勻
笉	竹 畇
梫	木 彐 冖 又
赾	走 斤
寑	宀 侵
锓	金 彐 冖 又	钅 彐 冖 又
寝	宀 丬 彐 冖 又
寢	宀 爿 彐 冖 又
鋟	金 彐 冖 又	釒 彐 冖 又
螼	虫 堇
螼	蟲 堇	虫 堇
吢	心 口
吣	口 心
抋	手 心	扌 心	才 心
沁	水 心	氵 心
唚	口 彐 冖 又
菣	草 臣 又	艸 臣 又	艹 臣 又
揿	手 钦	扌 钦	才 钦
搇	手 衾	扌 衾	才 衾
撳	手 欽	扌 欽	才 欽
瀙	水 親	氵 親
藽	草 親	艸 親	艹 親
靑	丰 円	三 丨 円
青	丰 月
青	丰 月	三 丨 月
氢	气 𢀖
轻	车 𢀖
倾	人 顷	亻 顷
卿	卯 艮 卩	丿 𠄌 丿 即
郬	青 邑	青 阝
圊	囗 青
埥	土 青
寈	宀 青
氫	氣 巠	气 巠
淸	水 靑	氵 靑
清	水 青	氵 青
傾	人 頃	亻 頃
蜻	虫 青
蜻	蟲 青	虫 青
輕	車 巠
鲭	鱼 青
鑋	輕 金
夝	夕 生
甠	日 生
剠	京 刀	京 刂
勍	京 力
情	心 青	忄 青
殑	歹 克
晴	日 青
棾	林 冗
氰	气 青
氰	氣 青	气 青
葝	草 勁	艸 勁	艹 勁
暒	日 星
擏	手 敬	扌 敬	才 敬
樈	木 竟
擎	敬 手
檠	敬 木
黥	黑 京
苘	草 冋	艸 冋	艹 冋
顷	匕 页
请	言 青	讠 青
庼	广 顷
頃	匕 頁
廎	广 頃
漀	殸 水
漀	殸 水	声 殳 水
請	言 青	訁 青
檾	火 火 冖 林	𤇾 林
庆	广 大
凊	冰 青	冫 青
掅	手 青	扌 青	才 青
殸	声 殳
碃	石 青
箐	竹 青
靘	青 色
慶	广 乛 一 丨 丨 乛 心 夕	广 乛 一 丨 丨 乛 心 夂
磬	声 殳 石	殸 石
儬	人 靚	亻 靚
濪	水 靘	氵 靘
罄	声 殳 缶	殸 缶
謦	殸 言
芎	草 弓	艸 弓	艹 弓
卭	工 卩
邛	工 邑	工 阝
宆	宀 弓
穷	穴 力
穹	穴 弓
茕	草 冖 卂	艸 冖 卂	艹 冖 卂
桏	木 邛
笻	竹 卭
筇	竹 邛
赹	走 勻
赹	走 匀
惸	心 旬 子	忄 旬 子
焪	火 穹
焭	火 火 冖 几	𤇾 几
琼	玉 京	王 京
舼	舟 共
蛩	巩 虫
蛩	巩 蟲	巩 虫
蛬	共 虫
蛬	共 蟲	共 虫
煢	火 火 冖 卂	𤇾 卂
睘	罒 一 口 衣
跫	巩 足
銎	金 巩	釒 巩
瞏	目 袁	罒 袁
窮	穴 躬
儝	人 榮	亻 榮
憌	鈞 心
橩	木 焭
璚	玉 矞	王 矞
藑	草 夐	艸 夐	艹 夐
瓊	玉 夐	王 夐
竆	穴 躳
藭	草 窮	艸 窮	艹 窮
瓗	玉 巂	王 巂
丘	厂 工	厂 丅 一
丠	北 一
邱	丘 邑	丘 阝
坵	土 丘
恘	心 休	忄 休
秋	禾 火
秌	火 禾
蚯	虫 丘
蚯	蟲 丘	虫 丘
媝	秋 女
萩	草 秋	艸 秋	艹 秋
楸	木 秋
蓲	草 區	艸 區	艹 區
鹙	秋 鸟
篍	竹 秋
緧	絲 酋	糹 酋	糸 酋
蝵	秋 虫
蝵	秋 蟲	秋 虫
穐	禾 亀
趥	走 酋
鳅	鱼 秋
蟗	一 口 丨 冂 出 虫
蟗	一 口 丨 冂 出 蟲	一 口 丨 冂 出 虫
鞦	革 秋
鞧	革 酋
鰌	魚 酋
鰍	魚 秋
鶖	秋 鳥
蠤	酋 虫 虫
蠤	酋 蟲 蟲	酋 虫 虫
龝	禾 龜
叴	九 口
囚	囗 人
扏	手 九	扌 九	才 九
犰	犬 九	犭 九
玌	玉 乚	王 乚
汓	水 子	氵 子
肍	肉 九	月 九
求	水 一 丶
虬	虫 乚
泅	水 囚	氵 囚
虯	蟲 丩	虫 丩
俅	人 求	亻 求
觓	角 丩
訄	九 言
訅	言 九	訁 九
酋	丷 酉
釓	金 乚	釒 乚
唒	口 酉
浗	水 求	氵 求
紌	絲 尤	糹 尤	糸 尤
莍	草 求	艸 求	艹 求
逎	辵 酉	辶 酉
逑	辵 求	辶 求
釚	金 九	釒 九
梂	木 求
殏	歹 求
毬	毛 求
球	玉 求	王 求
赇	贝 求
崷	山 酋
巯	𢀖 亠 厶 川	𢀖 巟	𢀖 㐬
渞	水 首	氵 首
皳	求 皮
盚	求 皿
遒	辵 酋	辶 酋
煪	火 酋
絿	絲 求	糹 求	糸 求
蛷	虫 求
蛷	蟲 求	虫 求
裘	求 衣
巰	巠 亠 厶 川	巠 巟	巠 㐬
觩	角 求
賕	貝 求
璆	玉 翏	王 翏
蝤	虫 酋
蝤	蟲 酋	虫 酋
銶	金 求	釒 求
醔	秋 酉
鮂	魚 囚
鼽	鼻 九
鯄	魚 求
鰽	魚 曹
搝	手 臭	扌 臭	才 臭
糗	米 臭
区	匚 乂	匚 乂
曲	囗 卄	曰 丨 丨
曲	曰 丨 丨	囗 卄
伹	人 且	亻 且
佉	人 去	亻 去
匤	匚 玉
岖	山 区
诎	言 出	讠 出
阹	阜 去	阝 去
驱	马 区
坥	土 且
屈	尸 出
岨	山 且
岴	山 丘
抾	手 去	扌 去	才 去
浀	水 曲	氵 曲
祛	示 去	礻 去
胠	肉 去	月 去
袪	衣 去	衤 去
區	匚 品	匚 品
紶	絲 去	糹 去	糸 去
蛆	虫 且
蛆	蟲 且	虫 且
躯	身 区
筁	竹 曲
蛐	虫 曲
蛐	蟲 曲	虫 曲
詘	言 出	訁 出
趋	走 刍
嶇	山 區
憈	心 虛	忄 虛
駆	馬 区
敺	區 攴
誳	言 屈	訁 屈
镼	镸 屈
镼	長 屈	镸 屈
駈	馬 丘
麹	麦 匊
髷	髟 曲
魼	魚 去
趨	走 芻
麯	麥 曲
覰	虘 見
軀	身 區
麴	麥 匊
麴	麥 匊	麥 勹 米
黢	黑 夋
覻	虎 豆 見	虍 豆 見
驅	馬 區
鰸	魚 區
鱋	魚 虛
佢	人 巨	亻 巨
劬	句 力
斪	句 斤
朐	月 句
胊	肉 句	月 句
菃	草 洰	艸 洰	艹 洰
鸲	句 鸟
淭	水 戶 木	氵 戶 木
淭	水 户 木
渠	洰 木
渠	洰 木	水 巨 木
絇	絲 句	糹 句	糸 句
翑	羽 句
葋	草 朐	艸 朐	艹 朐
軥	車 句
蕖	草 渠	艸 渠	艹 渠
璖	玉 渠	王 渠
磲	石 渠
螶	巨 虫 虫
螶	巨 蟲 蟲	巨 虫 虫
鴝	句 鳥
璩	玉 豦	王 豦
蟝	虫 渠
蟝	蟲 渠	虫 渠
瞿	目 目 隹
鼩	鼠 句
蘧	草 豦	艸 豦	艹 豦
忂	彳 瞿
灈	水 瞿	氵 瞿
戵	瞿 戈
欋	木 瞿
氍	瞿 毛
籧	竹 豦
臞	肉 瞿	月 瞿
癯	病 瞿	疒 瞿
蠷	虫 瞿
蠷	蟲 瞿	虫 瞿
衢	行 瞿	彳 瞿 亍
躣	足 瞿
蠼	虫 瞿 又
蠼	蟲 瞿 又	虫 瞿 又
鑺	金 瞿	釒 瞿
鸜	瞿 鳥
取	耳 又
竘	立 句
娶	取 女
詓	言 去	訁 去
竬	立 禹
蝺	虫 禹
蝺	蟲 禹	虫 禹
龋	齿 禹
齲	齒 禹
厺	大 厶
去	土 厶
刞	且 刀	且 刂
呿	口 去
耝	耒 且
阒	门 狊
觑	虚 见
趣	走 取
閴	門 貝
麮	麥 去
闃	門 狊
覷	虛 見
鼁	去 黽
峑	山 全
弮	丷 夫 弓	𠔉 弓
恮	心 全	忄 全
悛	心 夋	忄 夋
圈	囗 卷
圏	囗 卷
棬	木 卷
駩	馬 全
鐉	金 巽	釒 巽
全	人 王
权	木 又
佺	人 全	亻 全
诠	言 全	讠 全
姾	女 全
泉	白 水
洤	水 全	氵 全
荃	草 全	艸 全	艹 全
拳	丷 夫 手	𠔉 手
牷	牛 全	牜 全
辁	车 全
啳	口 卷
埢	土 卷
婘	女 卷
惓	心 卷	忄 卷
痊	病 全	疒 全
硂	石 全
铨	金 全	钅 全
湶	水 泉	氵 泉
犈	牛 卷	牜 卷
筌	竹 全
絟	絲 全	糹 全	糸 全
葲	草 泉	艸 泉	艹 泉
搼	手 拳	扌 拳	才 拳
瑔	玉 泉	王 泉
觠	丷 夫 角	𠔉 角
詮	言 全	訁 全
跧	足 全
輇	車 全
蜷	虫 卷
蜷	蟲 卷	虫 卷
銓	金 全	釒 全
権	木 丿 二 隹
踡	足 卷
縓	絲 原	糹 原	糸 原
醛	酉 荃
鳈	鱼 泉
鬈	髟 卷
騡	馬 泉
孉	女 雚
巏	山 雚
鰁	魚 泉
權	木 雚
齤	丷 夫 齒	𠔉 齒
蠸	虫 雚	虫 艹 口 口 隹
蠸	蟲 雚	虫 雚
颧	雚 页
顴	雚 頁
犭	丶 亅 丿
犬	大 丶
汱	水 犬	氵 犬
畎	田 犬
烇	火 全
绻	丝 卷	纟 卷
綣	絲 卷	糹 卷	糸 卷
虇	草 弓 雚	艸 弓 雚	艹 弓 雚
劝	又 力
券	丷 夫 刀	𠔉 刀
牶	丷 夫 牛	𠔉 牛
勧	丿 二 隹 力
韏	丷 夫 韋	𠔉 韋
勸	雚 力
缺	缶 夬
蒛	草 缺	艸 缺	艹 缺
阙	门 欮
瘸	病 加 肉	疒 加 肉
却	去 卩
卻	谷 卩
埆	土 角
崅	山 角
悫	壳 心
琷	玉 羌	王 羌
雀	少 隹
硞	石 告
确	石 角
阕	门 癸
塙	土 高
搉	手 隺	扌 隺	才 隺
皵	昔 皮
碏	石 昔
鹊	昔 鸟
愨	士 冖 一 殳 心
榷	木 隺
墧	土 喬
慤	壳 殳 心	殼 心
確	石 隺
碻	石 高
趞	走 昔
燩	火 敫
闋	門 癸
礐	臼 爻 冖 石	𦥯 石
闕	門 欮
鵲	昔 鳥
礭	石 霍
夋	厶 八 夂
囷	囗 禾
峮	山 君
逡	辵 夋	辶 夋
宭	宀 君
帬	尹 吊
裙	衣 君	衤 君
羣	君 羊
群	君 羊
裠	君 衣
呥	口 冉
肰	肉 犬	月 犬
衻	衣 冄	衤 冄
袇	衣 丹	衤 丹
蚦	虫 冄
蚦	蟲 冄	虫 冄
袡	衣 冉	衤 冉
蚺	虫 冉
蚺	蟲 冉	虫 冉
然	肉 犬 火	月 犬 灬
髥	髟 冄
嘫	口 然
髯	髟 冉
燃	火 然
繎	絲 然	糹 然	糸 然
冄	冂 二
冉	冂 十 一
姌	女 冉
苒	草 冉	艸 冉	艹 冉
染	水 九 木	氵 九 木	氿 木
珃	玉 冉	王 冉
媣	女 染
橪	木 然
穣	禾 衣 八 井 一
儴	人 襄	亻 襄
勷	襄 力
瀼	水 襄	氵 襄
獽	犬 襄	犭 襄
蘘	草 襄	艸 襄	艹 襄
禳	示 襄	礻 襄
瓤	襄 瓜
穰	禾 襄
躟	足 襄
鬤	髟 襄
壌	土 衣 八 井 一
嚷	口 襄
壤	土 襄
攘	手 襄	扌 襄	才 襄
爙	火 襄
纕	絲 襄	糹 襄	糸 襄
让	言 上	讠 上
懹	心 襄	忄 襄
譲	言 衣 八 井 一	訁 衣 八 井 一
讓	言 襄	訁 襄
娆	女 尧
荛	草 尧	艸 尧	艹 尧
饶	食 尧	饣 尧
桡	木 尧
嬈	女 堯
蕘	草 堯	艸 堯	艹 堯
橈	木 堯
襓	衣 堯	衤 堯
饒	食 堯	飠 堯
扰	手 尤	扌 尤	才 尤
隢	阜 堯	阝 堯
擾	手 憂	扌 憂	才 憂
绕	丝 尧	纟 尧
遶	辵 堯	辶 堯
繞	絲 堯	糹 堯	糸 堯
惹	若 心
热	执 火	执 灬
熱	埶 灬	執 火
人	丿 乀
亻	丿 丨
仁	人 二	亻 二
壬	丿 士
忈	二 心
朲	木 人
忎	千 心
秂	禾 人
芢	草 仁	艸 仁	艹 仁
鈓	金 壬	釒 壬
魜	魚 人
銋	金 任	釒 任
鵀	任 鳥
忍	刃 心
荏	草 任	艸 任	艹 任
栠	任 木
栣	木 任
荵	草 忍	艸 忍	艹 忍
秹	禾 任
棯	木 念
稔	禾 念
刃	刀 丶
刄	刀 乀
认	言 人	讠 人
仞	人 刃	亻 刃
仭	人 刄	亻 刄
讱	言 刃	讠 刃
任	人 壬	亻 壬
屻	山 刃
扨	手 刄	扌 刄	才 刄	手 刃
纫	丝 刃	纟 刃
妊	女 壬
杒	木 刃
牣	牛 刃	牜 刃
纴	丝 壬	纟 壬
肕	肉 刃	月 刃
轫	车 刃
韧	韦 刃
饪	食 壬	饣 壬
姙	女 任
紉	絲 刃	糹 刃	糸 刃
衽	衣 壬	衤 壬
紝	絲 壬	糹 壬	糸 壬
訒	言 刃	訁 刃
軔	車 刃
梕	木 忍
袵	衣 任	衤 任
絍	絲 任	糹 任	糸 任
腍	肉 念	月 念
葚	草 甚	艸 甚	艹 甚
靭	革 刃
靱	革 刄
韌	韋 刃
飪	食 壬	飠 壬
認	言 忍	訁 忍
餁	食 任
扔	手 乃	扌 乃	才 乃
仍	人 乃	亻 乃
辸	辵 乃	辶 乃
礽	示 乃	礻 乃
陾	阜 耎	阝 耎
芿	草 仍	艸 仍	艹 仍
日	口 一	口 丶
日	口 一	囗 一	囗 丶
驲	马 日
囸	囗 正
釰	金 刃	釒 刃
鈤	金 日	釒 日
馹	馬 日
茸	草 耳	艸 耳	艹 耳
戎	十 戈	一 十 戈
肜	肉 彡	月 彡
栄	小 冖 木
狨	犬 戎	犭 戎
绒	丝 戎	纟 戎
茙	草 戎	艸 戎	艹 戎
荣	草 冖 木	艸 冖 木	艹 冖 木
容	宀 谷
峵	山 宏
毧	毛 戎
烿	火 彤
媶	女 茸
嵘	山 荣
搑	手 茸	扌 茸	才 茸
絨	絲 戎	糹 戎	糸 戎
羢	羊 戎
嫆	女 容
嵤	火 火 冖 山	火 火 冚	𤇾 山
搈	手 容	扌 容	才 容
榵	木 茸
溶	水 容	氵 容
蓉	草 容	艸 容	艹 容
榕	木 容
榮	火 火 冖 木	𤇾 木
熔	火 容
瑢	玉 容	王 容
穁	禾 茸
縙	絲 茸	糹 茸	糸 茸
蝾	虫 荣
褣	衣 容	衤 容
镕	金 容	钅 容
融	鬲 虫
融	鬲 蟲	鬲 虫
螎	虫 鬲
螎	蟲 鬲	虫 鬲
駥	馬 戎
髶	髟 耳
嶸	山 榮
爃	火 榮
鎔	金 容	釒 容
巆	山 營
瀜	水 融	氵 融
曧	日 融
蠑	蟲 榮	虫 榮
冗	冖 几
宂	宀 几
坈	土 冗
傇	人 茸	亻 茸
軵	車 付
氄	矞 毛
厹	九 厶
禸	冂 厶
柔	矛 木
粈	米 丑
媃	女 柔
揉	手 柔	扌 柔	才 柔
渘	水 柔	氵 柔
葇	草 柔	艸 柔	艹 柔
煣	火 柔
瑈	玉 柔	王 柔
腬	肉 柔	月 柔
糅	米 柔
蝚	虫 柔
蝚	蟲 柔	虫 柔
蹂	足 柔
輮	車 柔
鍒	金 柔	釒 柔
鞣	革 柔
瓇	玉 憂	王 憂
騥	馬 柔
鰇	魚 柔
鶔	柔 鳥
楺	木 柔
韖	韋 柔
肉	冂 人 人	冂 入 入
宍	宀 六
邚	女 邑	女 阝
如	女 口
侞	人 如	亻 如
帤	如 巾
茹	草 如	艸 如	艹 如
桇	如 木
袽	衣 如	衤 如
铷	金 如	钅 如
渪	水 禹	氵 禹
筎	竹 如
蒘	草 挐	艸 挐	艹 挐	茹 手
銣	金 如	釒 如
蕠	草 絮	艸 絮	艹 絮
蝡	虫 耎
蝡	蟲 耎	虫 耎
儒	人 需	亻 需
鴑	奴 鳥
嚅	口 需
嬬	女 需
孺	子 需
濡	水 需	氵 需
薷	草 需	艸 需	艹 需
鴽	如 鳥
曘	日 需
燸	火 需
襦	衣 需	衤 需
蠕	虫 需
蠕	蟲 需	虫 需
颥	需 页
醹	酉 需
顬	需 頁
鱬	魚 需
汝	水 女	氵 女
肗	肉 女	月 女
乳	孚 乙	孚 乚
乳	孚 乚
辱	辰 寸
鄏	辱 邑	辱 阝
擩	手 需	扌 需	才 需
入	乁 丿
洳	水 如	氵 如
嗕	口 辱
媷	女 辱
溽	水 辱	氵 辱
缛	丝 辱	纟 辱
蓐	草 辱	艸 辱	艹 辱
褥	衣 辱	衤 辱
縟	絲 辱	糹 辱	糸 辱
挼	手 妥	扌 妥	才 妥
堧	土 耎
撋	手 閏	扌 閏	才 閏
壖	土 需
阮	阜 元	阝 元
朊	月 元
软	车 欠
耎	而 大
偄	人 耎	亻 耎
軟	車 欠
媆	女 耎
瑌	玉 耎	王 耎
碝	石 耎
緛	絲 耎	糹 耎	糸 耎
輭	車 耎
瓀	玉 需	王 需
礝	石 需
婑	女 委
桵	木 妥
甤	豕 生
緌	絲 委	糹 委	糸 委
蕤	草 豕 生	艸 豕 生	艹 豕 生
蕊	草 惢	艸 惢	艹 惢	芯 心 心
蕋	草 歮	艸 歮	艹 歮
橤	惢 木
繠	惢 糸
蘂	草 橤	艸 橤	艹 橤	蕊 木
蘃	草 歮 木	艸 歮 木	艹 歮 木
汭	水 內	氵 內
汭	水 内	氵 内
芮	草 內	艸 內	艹 內
枘	木 內
枘	木 内
蚋	虫 内
蚋	蟲 內	虫 內
锐	金 兑	钅 兑
瑞	玉 耑	王 耑
蜹	虫 芮
蜹	蟲 芮	虫 芮
睿	卜 冖 一 八 人 目
銳	金 兌	釒 兌
鋭	金 兑	釒 兑
叡	睿 又
壡	睿 圣
瞤	目 閏
闰	门 王
润	水 闰	氵 闰
閏	門 王
閠	門 玉
潤	水 閏	氵 閏
橍	木 閏
膶	肉 閏	月 閏
捼	手 委	扌 委	才 委
叒	又 又 又
若	草 右	艸 右	艹 右
偌	人 若	亻 若
弱	弓 冰 弓 冰	弓 冫 弓 冫
鄀	若 邑	若 阝
渃	水 若	氵 若
焫	火 芮
楉	木 若
蒻	草 弱	艸 弱	艹 弱
箬	竹 若
篛	竹 弱
爇	蓺 火	蓺 灬	草 熱	艸 熱	艹 熱
鰙	魚 若
鰯	魚 弱
鶸	弱 鳥
仨	人 三	亻 三
挱	手 沙	扌 沙	才 沙
挲	沙 手
撒	手 散	扌 散	才 散
洒	水 西	氵 西
訯	言 及	訁 及
靸	革 及
潵	水 散	氵 散
灑	水 麗	氵 麗
躠	薛 足
卅	川 一
泧	水 戉	氵 戉
钑	金 及	钅 及
飒	立 风
脎	肉 杀	月 杀
萨	草 阜 产	艸 阜 产	艹 阝 产
鈒	金 及	釒 及
摋	手 殺	扌 殺	才 殺
馺	馬 及
颯	立 風
薩	草 阜 產	艸 阜 產	艹 阝 產
櫒	木 蔡
毢	毛 西
愢	心 思	忄 思
揌	手 思	扌 思	才 思
塞	宀 井 大 土
毸	毛 思
腮	肉 思	月 思
嘥	口 徙
噻	口 塞
鳃	鱼 思
顋	思 頁
鰓	魚 思
嗮	口 晒
赛	宀 井 大 贝
僿	人 塞	亻 塞
賽	宀 井 大 貝
簺	竹 塞
三	一 二	一 一 一
弎	弋 三
叁	厶 大 三
毵	参 毛
毿	參 毛
犙	牛 參	牜 參
鬖	髟 參
仐	人 十
伞	人 丷 十
傘	人 人 人 人 十
糁	米 参
糂	米 甚
馓	饣 散
糝	米 參
糣	米 旡 旡 日	米 朁
糤	米 散
繖	絲 散	糹 散	糸 散
鏒	金 參	釒 參
鏾	金 散	釒 散
饊	食 散
俕	人 宋	亻 宋
帴	巾 戔
散	井 月 攴	井 月 攵
閐	門 毛
桒	卉 木
桑	木 叒	木 又 又 又
嗓	口 桑
搡	手 桑	扌 桑	才 桑
磉	石 桑
褬	衣 桑	衤 桑
颡	桑 页
鎟	金 桑	釒 桑
顙	桑 頁
丧	土 丷 衣
喪	土 口 口 衣
掻	手 又 虫	扌 又 虫	才 又 虫
掻	手 又 蟲	扌 又 虫	才 又 虫
慅	心 蚤	忄 蚤
搔	手 蚤	扌 蚤	才 蚤
溞	水 蚤	氵 蚤
骚	马 蚤
缫	丝 巢	纟 巢
繅	絲 巢	糹 巢	糸 巢
臊	肉 喿	月 喿
鳋	鱼 蚤
騒	馬 又 蟲	馬 又 虫
騷	馬 蚤
鰠	魚 蚤
鱢	魚 喿
扫	手 彐	扌 彐	才 彐
掃	手 帚	扌 帚	才 帚
嫂	女 叟
埽	土 帚
瘙	病 蚤	疒 蚤
氉	喿 毛
矂	目 喿
髞	高 喿
閪	門 西
色	刀 巴
洓	水 朿	氵 朿
栜	木 朿
涩	水 刃 止	氵 刃 止
啬	土 丷 回
铯	金 色	钅 色
雭	雨 及
歮	止 止 止
琗	玉 卒	王 卒
嗇	土 人 人 回	土 人 人 囗 口
瑟	玉 必	王 必
歰	刃 刃 止 止
銫	金 色	釒 色
澁	水 歮	氵 歮
懎	心 嗇	忄 嗇
擌	手 筴	扌 筴	才 筴
濇	水 嗇	氵 嗇
瘷	病 敕	疒 敕
穑	禾 啬
澀	水 歰	氵 歰
璱	玉 瑟	王 瑟
瀒	水 來 一 回	氵 來 一 回
穡	禾 嗇
繬	絲 嗇	糹 嗇	糸 嗇
轖	車 嗇
鏼	金 策	釒 策
譅	言 歰	訁 歰
飋	風 瑟
森	木 木 木	木 林
椮	木 参
槮	木 參
襂	衣 參	衤 參
僧	人 曽	亻 曽	人 曾	亻 曾
鬙	髟 曾
杀	乂 一 小	乂 木
沙	水 少	氵 少
纱	丝 少	纟 少
乷	沙 乙
刹	杀 刀	杀 刂
剎	乂 丶 木 刀	乂 丶 木 刂
砂	石 少
唦	口 沙
殺	杀 殳	乂 木 殳
猀	犬 沙	犭 沙
粆	米 少
紗	絲 少	糹 少	糸 少
莎	草 沙	艸 沙	艹 沙
桬	沙 木
铩	金 杀	钅 杀
痧	病 沙	疒 沙
硰	沙 石
煞	刍 攴 火	刍 攵 灬
蔱	草 殺	艸 殺	艹 殺
裟	沙 衣
榝	木 殺
樧	木 殺 丶
魦	魚 少
鲨	沙 鱼
鎩	金 殺	釒 殺
鯊	沙 魚
鯋	魚 沙
傻	人 囟 儿 夕	亻 囟 儿 夂
儍	人 凶 丶 丶 丶 丶 八 夕	亻 凶 丶 丶 丶 丶 八 夂
倽	人 舍	亻 舍
唼	口 妾
啑	口 疌
啥	口 舍
帹	巾 妾
萐	草 疌	艸 疌	艹 疌
厦	厂 夏
喢	口 臿
廈	广 夏
歃	臿 欠
翜	羽 夾
箑	竹 疌
翣	羽 妾
閯	門 沙
霎	雨 妾
筛	竹 师
酾	酉 丽
篩	竹 師
簁	竹 徙
簛	竹 斯
釃	酉 麗
繺	絲 煞	糹 煞	糸 煞
晒	日 西
閷	杀 閃
曬	日 麗
山	凵 丨
彡	丿 丿 丿
邖	山 邑	山 阝
删	册 刀	册 刂
刪	冊 刀	冊 刂
杉	木 彡
芟	草 殳	艸 殳	艹 殳
姍	女 冊
姗	女 册
苫	草 占	艸 占	艹 占
衫	衣 彡	衤 彡
钐	金 彡	钅 彡
埏	土 延
挻	手 延	扌 延	才 延
柵	木 冊
狦	犬 冊 一	犭 冊 一	犬 冄 丨 丨	犭 冄 丨 丨
珊	玉 冊	王 冊
舢	舟 山
痁	病 占	疒 占
脠	肉 延	月 延
軕	車 山
笘	竹 占
跚	足 冊
跚	足 册
剼	參 刀	參 刂
搧	手 扇	扌 扇	才 扇
嘇	口 參
幓	巾 參
煽	火 扇
潸	水 木 木 月	氵 木 木 月
澘	水 林 日	氵 林 日
檆	木 煔
縿	絲 參	糹 參	糸 參
膻	肉 亶	月 亶
鯅	魚 延
羴	羊 羊 羊
羶	羊 亶
闪	门 人
陕	阜 夹	阝 夹
炶	火 占
陝	阜 大 入 入	阝 大 入 入
閃	門 人
晱	日 炎
煔	炎 占
睒	目 炎
熌	火 閃
覢	炎 見
讪	言 山	讠 山
汕	水 山	氵 山
疝	病 山	疒 山
剡	炎 刀	炎 刂
扇	戶 羽	户 羽	戸 羽
訕	言 山	訁 山
赸	走 山
掞	手 炎	扌 炎	才 炎
釤	金 彡	釒 彡
傓	人 扇	亻 扇
善	羊 丷 一 口
椫	木 单
銏	金 册	釒 册
骟	马 扇
僐	人 善	亻 善
鄯	善 邑	善 阝
墠	土 單
墡	土 善
潬	水 單	氵 單
缮	丝 善	纟 善
嬗	女 亶
擅	手 亶	扌 亶	才 亶
樿	木 單
膳	肉 善	月 善
磰	石 善
謆	言 扇	訁 扇
赡	贝 詹
繕	絲 善	糹 善	糸 善
蟮	虫 善
蟮	蟲 善	虫 善
蟺	虫 亶
蟺	蟲 亶	虫 亶
譱	羊 言 言
贍	貝 詹
鐥	金 善	釒 善
饍	食 善
騸	馬 扇
鳝	鱼 善
灗	水 蟺	氵 蟺
鱓	魚 單
鱔	魚 善
伤	人 丿 一 力	亻 丿 一 力
殇	歹 丿 一 弓 丿 丿
商	亠 丷 冂 儿 口	亠 丷 冏
觞	角 丿 一 弓 丿 丿
傷	人 丿 一 昜	亻 丿 一 昜	人 丿 一 日 一 勿
墒	土 商
慯	心 丿 一 昜	忄 丿 一 昜
滳	水 商	氵 商
漡	水 丿 一 昜	氵 丿 一 昜
蔏	草 商	艸 商	艹 商
殤	歹 丿 一 昜
熵	火 商
螪	虫 商
螪	蟲 商	虫 商
觴	角 丿 一 昜
謪	言 商	訁 商
鬺	鬲 丿 一 昜
垧	土 向
扄	戶 向
扄	户 向
晌	日 向
赏	尚 贝
賞	尚 貝
鑜	金 賞	釒 賞
丄	丨 一
上	一 丨 一	丶 丨 一
尙	小 冋	小 冂 口
尚	小 冂 口
尚	小 冋	小 冂 口
恦	心 向	忄 向
绱	丝 尚	纟 尚
緔	絲 尚	糹 尚	糸 尚
鞝	革 尚
裳	尚 衣
弰	弓 肖
捎	手 肖	扌 肖	才 肖
烧	火 尧
莦	草 肖	艸 肖	艹 肖
梢	木 肖
焼	火 尭
稍	禾 肖
旓	方 丿 一 肖
筲	竹 肖
艄	舟 肖
蛸	虫 肖
蛸	蟲 肖	虫 肖
輎	車 肖
燒	火 堯
颵	風 肖
髾	髟 肖
鮹	魚 肖
勺	勹 丶
芍	草 勺	艸 勺	艹 勺
苕	草 召	艸 召	艹 召
柖	木 召
玿	玉 召	王 召
韶	音 召
少	小 丿
劭	召 力
卲	召 卩
邵	召 邑	召 阝
绍	丝 召	纟 召
哨	口 肖
娋	女 肖
袑	衣 召	衤 召
紹	絲 召	糹 召	糸 召
睄	目 肖
綤	邵 糸
潲	水 稍	氵 稍
奢	大 者
猞	犬 舍	犭 舍
赊	贝 佘
畬	余 田
畲	余 田
輋	山 大 車
賒	貝 佘
賖	貝 余
檨	木 羨
舌	千 口
佘	人 示
虵	虫 衆
虵	蟲 衆	虫 衆
蛇	虫 它
蛇	蟲 它	虫 它
蛥	虫 多
蛥	蟲 多	虫 多
舍	人 舌
捨	手 舍	扌 舍	才 舍
厍	厂 车
设	言 殳	讠 殳
社	示 土	礻 土
厙	厂 車
射	身 寸
涉	水 步	氵 步
涻	水 舍	氵 舍
渉	水 歩	氵 歩
設	言 殳	訁 殳
赦	赤 攴	赤 攵
弽	弓 枼
慑	心 聂	忄 聂
摂	手 耳 丷 八	扌 耳 丷 八	才 耳 丷 八
摄	手 聂	扌 聂
摄	手 聂	扌 聂	才 聂
滠	水 聂	氵 聂
慴	心 習	忄 習
摵	手 戚	扌 戚	才 戚
蔎	草 設	艸 設	艹 設
歙	翕 欠
蠂	虫 葉
蠂	蟲 葉	虫 葉
韘	韋 枼
騇	馬 舍
懾	心 聶	忄 聶
攝	手 聶	扌 聶	才 聶
灄	水 聶	氵 聶
麝	鹿 射
欇	木 聶
谁	言 隹	讠 隹
申	囗 十
屾	山 山
扟	手 卂	扌 卂	才 卂
伸	人 申	亻 申
身	丶 且 丿
侁	人 先	亻 先
呻	口 申
妽	女 申
籶	米 几
绅	丝 申	纟 申
罙	网 木	罒 木	㓁 木
诜	言 先	讠 先
姺	女 先
柛	木 申
氠	气 申
氠	氣 申	气 申
珅	玉 申	王 申
穼	穴 木
籸	米 卂
娠	女 辰
峷	山 辛
甡	生 生
眒	目 申
砷	石 申
莘	草 辛	艸 辛	艹 辛
敒	伸 攴	伸 攵
深	水 罙	氵 罙
紳	絲 申	糹 申	糸 申
兟	先 先
棽	林 今
葠	草 侵	艸 侵	艹 侵
裑	衣 身	衤 身
訷	言 申	訁 申
蓡	草 浸	艸 浸	艹 浸
詵	言 先	訁 先
甧	生 生 月
蔘	草 參	艸 參	艹 參
燊	焱 木	火 火 火 木
薓	草 水 帚 又	艸 氵 帚 又	艹 氵 帚 又
駪	馬 先
鲹	鱼 参
曑	晶 人 彡
鯓	魚 身
鵢	身 鳥
鯵	魚 參
鰺	魚 參
什	人 十	亻 十
甚	甘 匹	其 乚
神	示 申	礻 申
榊	木 神
邥	冘 邑	冘 阝
弞	弓 欠
沈	水 冘	氵 冘
审	宀 申
矤	弓 矢
哂	口 西
矧	矢 引
宷	宀 釆
谂	言 念	讠 念
谉	言 审	讠 审
婶	女 审
渖	水 审	氵 审
訠	言 引	訁 引
審	宀 番
諗	言 念	訁 念
頣	臣 頁
魫	魚 冘
曋	日 覃
瞫	目 覃
嬸	女 審
瀋	水 審	氵 審
覾	審 見
讅	言 審	訁 審
肾	丨 丨 又 肉	丨 丨 又 月
侺	人 岑	亻 岑
昚	大 丷 日
胂	肉 申	月 申
涁	水 杉	氵 杉
眘	大 丷 目
渗	水 参	氵 参
祳	示 辰	礻 辰
脤	肉 辰	月 辰
腎	臤 肉	臤 月
愼	心 眞	忄 眞
慎	心 真	忄 真
椹	木 甚
瘆	病 参	疒 参
罧	网 林	罒 林	罓 林
蜃	辰 虫
蜃	辰 蟲	辰 虫
蜄	虫 辰
蜄	蟲 辰	虫 辰
滲	水 參	氵 參
鋠	金 辰	釒 辰
瘮	病 參	疒 參
升	千 丨	丿 十 丿
生	牛 一	丿 三 丨
阩	阜 升	阝 升
呏	口 升
声	士 尸 丨
斘	夕 斗
昇	日 升
枡	木 升
泩	水 生	氵 生
狌	犬 生	犭 生
苼	草 生	艸 生	艹 生
殅	歹 生
牲	牛 生	牜 生
珄	玉 生	王 生
陞	阜 升 土	阝 升 土
笙	竹 生
湦	水 星	氵 星
焺	火 昇
甥	生 男
鉎	金 生	釒 生
聲	声 殳 耳	殸 耳
鍟	金 星	釒 星
鼪	鼠 生
鵿	鳥 昇
绳	丝 黾	纟 黾
憴	心 黽	忄 黽
繩	絲 黽	糹 黽	糸 黽
譝	言 黽	訁 黽
省	少 目
眚	生 目
偗	人 省	亻 省
渻	水 省	氵 省
圣	又 土
胜	肉 生	月 生
晠	日 成
剰	乗 刀	乗 刂
盛	成 皿
剩	乘 刀	乘 刂
勝	肉 劵	月 劵	月 丷 夫 力
貹	貝 生
嵊	山 乘
琞	明 玉
聖	耳 口 王
墭	土 盛
榺	肉 桊	月 桊
蕂	草 勝	艸 勝	艹 勝
賸	肉 丷 夫 貝	月 丷 夫 貝	肉 𠔉 貝	月 𠔉 貝
尸	乛 一 丿
失	丿 夫	丶 夫
师	丨 丿 帀
呞	口 司
虱	乙 一 虫
虱	乙 一 蟲	乙 一 虫
诗	言 寺	讠 寺
邿	寺 邑	寺 阝
鸤	尸 鸟
屍	尸 死
施	方 丿 一 也
浉	水 师	氵 师
狮	犬 师	犭 师
師	戶 乛 一 帀	户 乛 一 帀
絁	絲 丿 一 也	糹 丿 一 也	糸 丿 一 也
釶	金 也	釒 也
湤	水 施	氵 施
湿	水 显	氵 显
葹	草 施	艸 施	艹 施
溮	水 師	氵 師
溼	水 一 幺 幺 土	氵 一 幺 幺 土
獅	犬 師	犭 師
蒒	草 師	艸 師	艹 師
蓍	草 耆	艸 耆	艹 耆
詩	言 寺	訁 寺
鉇	金 丿 一 也	釒 丿 一 也
鉈	金 它	釒 它
鳲	尸 鳥
蝨	卂 蟲 蟲	卂 虫 虫
鳾	帀 鳥
褷	衣 徙	衤 徙
鲺	鱼 虱
濕	水 日 幺 幺 火	氵 日 幺 幺 灬	水 㬎	氵 㬎
鍦	金 施	釒 施
鯴	魚 虱
鰤	魚 師
鶳	鳥 師
襹	衣 麗	衤 麗
十	一 丨
饣	人 良 飠
石	一 丿 口
辻	辵 十	辶 十
乭	石 乙
时	日 寸
识	言 只	讠 只
实	宀 头
実	宀 二 大
旹	山 一 日	屮 一 日
飠	人 良
姼	女 多
峕	山 亠 日
拾	手 合	扌 合	才 合
炻	火 石
祏	示 石	礻 石
蚀	食 虫	饣 虫
食	人 良
埘	土 时
時	日 寺
莳	草 时	艸 时	艹 时
寔	宀 是
湜	水 是	氵 是
遈	辵 是	辶 是
塒	土 時
溡	水 時	氵 時
蒔	草 時	艸 時	艹 時
鉐	金 石	釒 石
實	宀 貫
榯	木 時
蝕	食 蟲	飠 虫	食 虫
鲥	鱼 时
鼫	鼠 石
識	言 戠	訁 戠
鼭	鼠 寺
鰣	魚 時
史	口 乂
矢	丿 天
乨	台 乙	台 乚
豕	一 丿 亅 丿 丿 丶 乀
使	人 吏	亻 吏
始	女 台
驶	马 史
兘	元 台
宩	宀 米
屎	尸 米
笶	竹 矢
鉂	金 史	釒 史
駛	馬 史
士	十 一
氏	丿 𠄌 一 𠄌
礻	丶 乙 丨 丶
丗	廿 丨	十 凵
世	廿 丨 一
仕	人 士	亻 士
市	亠 巾
示	二 小
似	人 以	亻 以
卋	十 廿
式	弋 工
忕	心 大	忄 大
亊	一 丷 亅 聿	一 丷 亅 肀
叓	十 口 又	支 口
戺	戶 巳
戺	户 巳
事	一 口 聿	一 口 肀
侍	人 寺	亻 寺
势	埶 力 勢	执 力 勢
呩	口 示
柹	木 丿 乛 丨 丿
柹	木 丿 乛 丨 丿	木 𠂔
视	示 见	礻 见
试	言 式	讠 式
饰	食 丿 一 巾	饣 丿 一 巾	食 布
冟	冖 皀	冖 皂
冟	冖 皀	冖 皂	冖 白 匕
室	宀 至
恀	心 多	忄 多
恃	心 寺	忄 寺
拭	手 式	扌 式	才 式
是	日 疋	曰 疋
昰	日 正
枾	木 亠 十 丿 丨
柿	木 市
眂	目 氏
贳	世 贝
适	辵 舌	辶 舌
栻	木 式
烒	火 式
眎	目 示
眡	目 氐
舐	舌 氏
轼	车 式
逝	辵 折	辶 折
铈	金 市	钅 市
視	示 見	礻 見
豉	豆 支
釈	釆 尺
媞	女 是
崼	山 是
弑	杀 式
徥	彳 是
揓	手 施	扌 施	才 施
谥	言 兮 皿	讠 兮 皿
谥	言 益	讠 益
貰	世 貝
释	采 又 二 丨	釆 又 二 丨
勢	埶 力	執 力
嗜	口 耆	口 老 日
弒	杀 式
睗	目 易
筮	竹 巫
觢	丰 刀 角
試	言 式	訁 式
軾	車 式
鈰	金 市	釒 市
鉃	金 矢	釒 矢
飾	食 丿 一 巾	飠 丿 一 巾	食 布
舓	舌 易
誓	折 言
適	辵 啇	辶 啇
鉽	金 式	釒 式
奭	大 百 百
銴	折 金
餙	食 希
餝	食 芳
噬	口 筮
嬕	女 睪
澨	水 筮	氵 筮
諟	言 是	訁 是
諡	言 兮 皿	訁 兮 皿
遾	辵 筮	辶 筮
螫	赦 虫
螫	赦 蟲	赦 虫
謚	言 益	訁 益
簭	竹 筮 人 口
襫	衣 奭	衤 奭
釋	采 睪	釆 睪
匙	是 匕
収	丩 又
收	丩 攴	丩 攵
手	丿 二 亅
守	宀 寸
垨	土 守
首	丷 一 丶 目
艏	舟 首
寿	丰 寸
受	爪 冖 又	爫 冖 又
狩	犬 守	犭 守
兽	丷 田 一 口
售	隹 口
授	手 受	扌 受	才 受
涭	水 受	氵 受
绶	丝 受	纟 受
痩	病 申 又	疒 申 又
膄	肉 叟	月 叟
壽	士 乛 工 一 口 寸
夀	韦 口 一 口 寸	韦 口 一 吋
瘦	病 叟	疒 叟
綬	絲 受	糹 受	糸 受
獸	嘼 犬
鏉	金 欶	釒 欶
扌	一 亅 丿
书	乛 乛 丨 丶
殳	几 又
尗	上 小
抒	手 予	扌 予	才 予
纾	丝 予	纟 予
叔	上 小 又	尗 又
杸	木 殳
枢	木 区
陎	阜 朱	阝 朱
姝	女 朱
倏	攸 犬
倐	攸 火
書	聿 曰
殊	歹 朱
紓	絲 予	糹 予	糸 予
掓	手 叔	扌 叔	才 叔
梳	木 亠 厶 川	木 巟	木 㐬
淑	水 叔	氵 叔
焂	攸 火
菽	草 叔	艸 叔	艹 叔
軗	車 殳
鄃	俞 邑	俞 阝
疎	疋 束
疏	疋 亠 厶 川	疋 巟	疋 㐬
舒	舍 予
摅	手 虑	扌 虑
毹	俞 毛
毺	毛 俞
綀	絲 束	糹 束	糸 束
输	车 俞
瑹	玉 荼	王 荼
跾	攸 足
踈	足 束
樞	木 區
蔬	草 疏	艸 疏	艹 疏
輸	車 俞
橾	木 喿
鮛	魚 尗
儵	攸 黑	攸 黑
攄	手 慮	扌 慮	才 慮
鵨	舍 鳥
秫	禾 朮
婌	女 叔
孰	享 丸
赎	贝 卖
塾	孰 土
熟	孰 火	孰 灬
璹	玉 壽	王 壽
贖	貝 賣
鼡	小 用
属	尸 禹
暑	日 者
暏	日 者
黍	禾 人 水
黍	禾 人 水	秂 水
署	网 者	罒 者
蜀	罒 勹 虫
蜀	网 勹 蟲	罒 勹 蟲	罒 勹 虫
鼠	臼 𠄌 丶 丶 𠄌 丶 丶 乀
潻	水 黍	氵 黍
薥	草 蜀	艸 蜀	艹 蜀
薯	草 署	艸 署	艹 署
曙	日 署
癙	病 鼠	疒 鼠
藷	草 諸	艸 諸	艹 諸
襡	衣 蜀	衤 蜀
襩	衣 賣	衤 賣
屬	尸 二 丨 二 蜀
鸀	蜀 鳥
朮	木 丶	十 儿 丶
术	木 丶
戍	戊 丶
束	木 口
沭	水 朮	氵 朮
述	辵 术	辶 术
侸	人 豆	亻 豆
咰	口 旬
怷	朮 心
树	木 又 寸
竖	刂 又 立
竖	丨 丨 又 立
荗	草 戍	艸 戍	艹 戍
恕	女 口 心
捒	手 束	扌 束	才 束
庶	广 廿 火	广 廿 灬
庻	广 廿 人 人
絉	絲 术	糹 术	糸 术
蒁	草 述	艸 述	艹 述
術	行 木 丶	彳 木 丶 亍
隃	阜 俞	阝 俞
尌	壴 寸
裋	衣 豆	衤 豆
数	娄 攴	娄 攵
竪	臣 又 立
腧	肉 俞	月 俞
鉥	金 朮	釒 朮
墅	野 土
漱	水 欶	氵 欶
潄	水 敕	氵 敕
數	婁 攴	婁 攵
澍	水 尌	氵 尌
豎	臤 豆
樹	木 尌
濖	水 署	氵 署
錰	金 杰	釒 杰
鏣	金 庶	釒 庶
鶐	述 鳥
虪	虎 儵
刷	尸 巾 刀	尸 巾 刂
唰	口 刷
耍	而 女
誜	言 夋	訁 夋
衰	亠 口 一 中
衰	衣 中 一
摔	手 率	扌 率	才 率
甩	月 乚
帅	丨 丿 巾
帥	戶 乛 一 巾	户 乛 一 巾
蟀	虫 率
蟀	蟲 率	虫 率
卛	絲 言 十	糸 言 糸 十	䜌 十
闩	门 一
拴	手 全	扌 全	才 全
閂	門 一
栓	木 全
涮	水 刷	氵 刷
腨	肉 耑	月 耑
双	又 又
霜	雨 相
雙	隹 隹 又
孀	女 霜
骦	马 霜
孇	女 雙
騻	馬 爽
欆	木 雙
礵	石 霜
鷞	爽 鳥
鹴	霜 鸟
艭	舟 雙
驦	馬 霜
鸘	霜 鳥
爽	大 爻 爻	大 乂 乂 乂 乂
塽	土 爽
慡	心 爽	忄 爽
漺	水 爽	氵 爽
樉	木 爽
縔	絲 桑	糹 桑	糸 桑
灀	水 霜	氵 霜
脽	肉 隹	月 隹
誰	言 隹	訁 隹
水	乛 亅 丶 乀
帨	巾 兌
帨	巾 兑
涗	水 兌	氵 兌
涚	水 兑	氵 兑
祱	示 兌	礻 兌
祱	示 兑	礻 兑
稅	禾 兌
税	禾 兑
裞	衣 兌	衤 兌
裞	衣 兑	衤 兑
睡	目 垂
瞓	目 訓
氵	丶 丶 丿
吮	口 允
顺	川 页
舜	爪 冖 舛	爫 冖 舛
順	川 頁
蕣	草 舜	艸 舜	艹 舜
橓	木 舜
瞚	目 寅
瞬	目 舜
鬊	髟 春
说	言 兑	讠 兑
哾	口 兑
說	言 兌	訁 兌
説	言 兑	訁 兑
妁	女 勺
烁	火 乐
朔	屰 月
铄	金 乐	钅 乐
欶	束 欠
硕	石 页
矟	矛 肖
搠	手 朔	扌 朔	才 朔
蒴	草 朔	艸 朔	艹 朔
槊	木 朔
獡	犬 舄	犭 舄
碩	石 頁
箾	竹 削
鎙	金 朔	釒 朔
爍	火 樂
鑠	金 樂	釒 樂
厶	𠃊 丶
丝	纟 纟
司	乛 一 口
私	禾 厶
咝	口 丝
泀	水 司	氵 司
思	田 心
虒	厂 虎
鸶	丝 鸟
媤	女 思
斯	其 斤
絲	糹 糹	糸 糸
缌	丝 思	纟 思
蛳	虫 师
楒	木 思
禗	示 思	礻 思
鉰	金 司	釒 司
飔	风 思
凘	冰 斯	冫 斯
厮	厂 斯 廝
榹	木 虒
禠	示 虒	礻 虒
罳	网 思	罒 思
蜤	析 虫
蜤	析 蟲	析 虫
锶	金 思	钅 思
嘶	口 斯
噝	口 絲
廝	厂 斯
撕	手 斯	扌 斯	才 斯
澌	水 斯	氵 斯
磃	石 虒
緦	絲 思	糹 思	糸 思
蕬	草 絲	艸 絲	艹 絲
鋖	金 妥	釒 妥
燍	火 斯
螄	蟲 師	虫 師
蟖	虫 斯
蟖	蟲 斯	虫 斯
蟴	斯 虫
蟴	斯 蟲	斯 虫
颸	風 思
騦	馬 思
鐁	金 斯	釒 斯
鷥	絲 鳥
鼶	鼠 虒
籭	竹 麗
死	歹 匕	一 夕 匕
巳	乛 一 乚
亖	二 二
四	囗 儿
寺	土 寸
汜	水 巳	氵 巳
佀	人 尸 乛 一	亻 尸 乛 一
兕	凹 儿
姒	女 以
泤	水 以	氵 以
祀	示 巳	礻 巳
価	人 西	亻 西
孠	司 子
杫	木 止
泗	水 四	氵 四
饲	食 司	饣 司
驷	马 四
娰	女 似
柶	木 四
牭	牛 四	牜 四
涘	水 矣	氵 矣
肂	歹 聿
飤	食 人
笥	竹 司
耜	耒 尸 乛 一
釲	金 巳	釒 巳
竢	立 矣
覗	司 見
嗣	口 冊 司
肆	镸 聿
貄	豸 聿
鈶	金 台	釒 台
鈻	金 尸 乛 一	釒 尸 乛 一
飼	食 司	飠 司
禩	示 異	礻 異
駟	馬 四
蕼	草 肆	艸 肆	艹 肆
儩	人 賜	亻 賜
瀃	水 賜	氵 賜
忪	心 公	忄 公
松	木 公
枀	公 木 
娀	女 戎
柗	木 八 口
倯	人 松	亻 松
凇	冰 松	冫 松
崧	山 松
庺	广 枀
梥	宀 枀
淞	水 松	氵 松
菘	草 松	艸 松	艹 松
嵩	山 高
硹	石 松
蜙	虫 松
蜙	蟲 松	虫 松
憽	心 葱	忄 葱
濍	水 葱	氵 葱
檧	木 葱
鍶	金 思	釒 思
鬆	髟 松
怂	从 心
悚	心 束	忄 束
耸	从 耳
竦	立 束
傱	人 從	亻 從
愯	心 隻	忄 隻
楤	木 怱
嵷	山 從
慫	從 心
聳	從 耳
駷	馬 束
讼	言 公	讠 公
宋	宀 木
诵	言 甬	讠 甬
送	辵 关	辶 关
颂	公 页
訟	言 公	訁 公
頌	公 頁
誦	言 甬	訁 甬
餸	食 送	飠 送
凁	冰 束	冫 束
捜	手 叟	扌 叟	才 叟
鄋	叟 邑	叟 阝
嗖	口 叟
廀	广 叜
廋	广 叟
搜	手 叟	扌 叟	才 叟
溲	水 叟	氵 叟
獀	犬 叟	犭 叟
蒐	草 鬼	艸 鬼	艹 鬼
蓃	草 叟	艸 叟	艹 叟
馊	食 叟	饣 叟
摉	手 穴 人 夕	扌 穴 人 夕	才 穴 人 夕
飕	风 叟
锼	金 叟	钅 叟
艘	舟 叟
螋	虫 叟
螋	蟲 叟	虫 叟
醙	酉 叟
鎪	金 叟	釒 叟
餿	食 叟	飠 叟
颼	風 叟
颾	風 蚤
騪	馬 叟
叜	灾 又
叟	臼 丨 又
傁	人 叟	亻 叟
嗾	口 族
瞍	目 叟
擞	手 数	扌 数	才 数
薮	草 数	艸 数	艹 数
擻	手 數	扌 數	才 數
藪	草 數	艸 數	艹 數
櫢	木 數
籔	竹 數
嗽	口 欶	口 束 欠
瘶	病 欶	疒 欶
苏	草 办	艸 办	艹 办
甦	更 生
酥	酉 禾
稣	鱼 禾
窣	穴 卒
穌	魚 禾
蘇	草 穌	艸 穌	艹 穌
蘓	草 禾 魚	艸 禾 魚	艹 禾 魚
櫯	木 穌
囌	口 蘇
俗	人 谷	亻 谷
玊	王 丶
夙	几 歹
诉	言 斥	讠 斥
泝	水 斥	氵 斥
肃	聿 八 丿 丨	肀 八 丿 丨
洬	水 夙	氵 夙
涑	水 束	氵 束
珟	玉 夙	王 夙
素	丰 丝	丰 糸
素	丰 絲	丰 糸
莤	草 酉	艸 酉	艹 酉
速	辵 束	辶 束
宿	宀 人 百	宀 亻 百
梀	木 束
殐	歹 束
粛	聿 丿 米 丨	肀 丿 米 丨
骕	马 肃
傃	人 素	亻 素
粟	西 米	襾 米	覀 米
訴	言 斥	訁 斥
谡	言 畟	讠 畟
嗉	口 素
塐	土 素
塑	朔 土
嫊	女 素
愫	心 素	忄 素
溯	水 朔	氵 朔
溸	水 素	氵 素
肅	聿 片 爿	肀 片 一 爿
遡	辵 朔	辶 朔
鹔	肃 鸟
僳	人 粟	亻 粟
愬	朔 心
榡	木 素
膆	肉 素	月 素
蔌	草 欶	艸 欶	艹 欶
觫	角 束
趚	走 束
遬	辵 欶	辶 欶
憟	心 粟	忄 粟
樎	木 宿
樕	木 欶
潥	水 粟	氵 粟
碿	石 屑
鋉	金 束	釒 束
餗	食 束
潚	水 肅	氵 肅
縤	絲 素	糹 素	糸 素
橚	木 肅
璛	玉 肅	王 肅
簌	竹 欶
簌	竹 欶	竹 束 欠
藗	草 遬	艸 遬	艹 遬
謖	言 畟	訁 畟
蹜	足 宿
驌	馬 肅
鱐	魚 肅
鷫	肅 鳥
狻	犬 夋	犭 夋
痠	病 夋	疒 夋
酸	酉 夋
匴	匚 算
祘	示 示
笇	竹 卞
筭	竹 弄
蒜	草 示 示	艸 示 示	艹 示 示
算	竹 目 廾
芕	草 夕	艸 夕	艹 夕
虽	口 虫
倠	人 隹
倠	人 隹	亻 隹
哸	口 妥
浽	水 妥	氵 妥
荽	草 妥	艸 妥	艹 妥
荾	草 夋	艸 夋	艹 夋
眭	目 圭
葰	草 俊	艸 俊	艹 俊
滖	水 衰	氵 衰
睢	目 隹
綏	絲 妥	糹 妥	糸 妥
熣	火 崔
濉	水 睢	氵 睢
鞖	革 妥
雖	虽 隹
绥	丝 妥	纟 妥
隋	阜 左 月	阝 左 月
随	阜 迶	阝 迶	阜 辵 有
遀	辵 左 月	辶 左 月
隨	阜 遀	阝 遀	阜 辵 左 月
瓍	玉 隨	王 隨
瀡	水 隨	氵 隨
膸	肉 遀	月 遀
髄	骨 迶
髓	骨 遀
亗	山 二
岁	山 夕
砕	石 卆
祟	出 示
谇	言 卒	讠 卒
埣	土 卒
嵗	山 戊 丁 丶 丿	山 戊 一 小
遂	辵 丷 豕	辶 丷 豕
歲	止 戊 丁 丶 丿	止 戊 一 小
歳	止 戊 一 小
煫	火 丷 豕
睟	目 卒
碎	石 卒
隧	阜 遂	阝 遂
嬘	女 遂
澻	水 遂	氵 遂
穂	禾 恵
誶	言 卒	訁 卒
賥	貝 卒
檖	木 遂
燧	火 遂
璲	玉 遂	王 遂
禭	示 遂	礻 遂
穗	禾 惠
穟	禾 遂
繀	絲 崔	糹 崔	糸 崔
襚	衣 遂	衤 遂
邃	穴 遂	辵 穴 丷 豕	辶 穴 丷 豕
旞	方 丿 一 遂
繐	絲 惠	糹 惠	糸 惠
繸	絲 遂	糹 遂	糸 遂
譢	言 遂	訁 遂
鐆	隊 金
鐩	金 遂	釒 遂
韢	韋 惠
孙	子 小
狲	犬 孙	犭 孙
荪	草 孙	艸 孙	艹 孙
孫	子 系
飧	夕 食
搎	手 孫	扌 孫	才 孫
猻	犬 孫	犭 孫
蓀	草 孫	艸 孫	艹 孫
飱	歹 食
槂	木 孫
蕵	草 飧	艸 飧	艹 飧
薞	草 飱	艸 飱	艹 飱
损	手 员	扌 员	才 员
笋	竹 尹
隼	隹 十
筍	竹 旬
損	手 員	扌 員	才 員
榫	木 隼	木 隹 十
箰	筍 子
簨	竹 巽
鎨	金 隼	釒 隼
鶽	隼 鳥
唆	口 夋
娑	沙 女
莏	草 抄	艸 抄	艹 抄
傞	人 差	亻 差
桫	木 沙
梭	木 夋
睃	目 夋
嗍	口 朔
羧	羊 夋
蓑	草 衰	艸 衰	艹 衰
摍	手 宿	扌 宿	才 宿
缩	丝 宿	纟 宿
趖	走 坐
簑	竹 衰
簔	竹 衰
縮	絲 宿	糹 宿	糸 宿
髿	髟 沙
鮻	魚 夋
所	戶 斤	户 斤	戸 斤
唢	口 小 贝
索	十 冖 丝	十 冖 糸
索	十 冖 絲	十 冖 糸
琐	玉 小 贝	王 小 贝
惢	心 心 心
锁	金 小 贝	钅 小 贝
嗩	口 小 貝
暛	日 差
溑	水 小 貝	氵 小 貝
瑣	玉 小 貝	王 小 貝
褨	衣 差	衤 差
璅	玉 巢	王 巢
鎈	金 差	釒 差
鎍	金 索	釒 索
鎖	金 小 貝	釒 小 貝
鎻	金 巛 貝	釒 巛 貝
鏁	金 巢	釒 巢
逤	辵 沙	辶 沙
溹	水 索	氵 索
蜶	虫 卒
蜶	蟲 卒	虫 卒
嗦	口 索
他	人 也	亻 也
它	宀 匕
她	女 也
牠	牛 也	牜 也
祂	示 也	礻 也
趿	足 及
铊	金 它	钅 它
塌	土 日 羽	土 曰 羽
榙	木 荅
溻	水 日 羽	氵 日 羽
褟	衣 日 羽	衤 日 羽
嚃	口 遝
蹹	足 翕
塔	土 荅
溚	水 荅	氵 荅
墖	土 畣
獭	犬 赖	犭 赖
鳎	鱼 日 羽
獺	犬 賴	犭 賴
鰨	魚 日 羽
拓	手 石	扌 石	才 石
挞	手 达	扌 达	才 达
狧	犬 舌	犭 舌
闼	门 达
崉	山 沓
涾	水 沓	氵 沓
搨	手 日 羽	扌 日 羽	才 日 羽
遝	辵 眔	辶 眔
遢	辵 日 羽	辶 日 羽	辵 曰 羽	辶 曰 羽
榻	木 日 羽	木 曰 羽
毾	日 羽 毛
禢	示 日 羽	礻 日 羽
撻	手 達	扌 達	才 達
澾	水 達	氵 達
誻	言 沓	訁 沓
踏	足 沓
橽	木 達
錔	金 沓	釒 沓
濌	重 沓
蹋	足 日 羽
鞜	革 沓
鮙	魚 羽
闒	門 日 羽
鞳	革 荅
嚺	口 目 遂	口 网 遂	口 罒 遂
闥	門 達
譶	言 言 言
躢	足 闒
囼	囗 台
孡	子 台
胎	肉 台	月 台
台	厶 口
旲	日 大
邰	台 邑	台 阝
坮	土 台
抬	手 台	扌 台	才 台
苔	草 台	艸 台	艹 台
枱	木 台
炱	台 火
炲	火 台
菭	草 治	艸 治	艹 治
跆	足 台
鲐	鱼 台
箈	竹 治
臺	吉 冖 至
颱	風 台
駘	馬 台
儓	人 臺	亻 臺
鮐	魚 台
嬯	女 臺
擡	手 臺	扌 臺	才 臺
薹	草 臺	艸 臺	艹 臺
檯	木 臺
籉	竹 臺
太	大 丶
冭	大 冰	大 冫
夳	大 二
忲	心 太	忄 太
汰	水 太	氵 太
态	太 心
肽	肉 太	月 太
钛	金 太	钅 太
泰	手 乀 水	𡗗 水
舦	舟 太
酞	酉 太
鈦	金 太	釒 太
溙	水 泰	氵 泰
態	能 心
燤	火 萬
坍	土 丹
贪	今 贝
怹	他 心
痑	病 多	疒 多
舑	舌 冉
貪	今 貝
摊	手 难	扌 难	才 难
滩	水 难	氵 难
瘫	病 难	疒 难
擹	手 歎	扌 歎	才 歎
攤	手 難	扌 難	才 難
灘	水 難	氵 難
癱	病 難	疒 難
坛	土 云
昙	日 云
倓	人 炎	亻 炎
谈	言 炎	讠 炎
郯	炎 邑	炎 阝
婒	女 炎
惔	心 炎	忄 炎
覃	西 早	襾 早	覀 早
榃	林 田
痰	病 炎	疒 炎
锬	金 炎	钅 炎
谭	言 覃	讠 覃
墰	土 覃
墵	土 雲
憛	心 覃	忄 覃
潭	水 覃	氵 覃
談	言 炎	訁 炎
醈	酉 炎
壇	土 亶
曇	日 雲
燂	火 覃
錟	金 炎	釒 炎
餤	食 炎
檀	木 亶
磹	石 覃
顃	炎 頁
罈	缶 覃
藫	水 蕈	氵 蕈
壜	土 曇
譚	言 覃	訁 覃
貚	豸 單
醰	酉 覃
譠	言 亶	訁 亶
罎	缶 曇
忐	上 心
坦	土 旦
袒	衣 旦	衤 旦
钽	金 旦	钅 旦
菼	草 炎	艸 炎	艹 炎
毯	毛 炎
鉭	金 旦	釒 旦
嗿	口 貪
憳	心 尋	忄 尋
憻	心 亶	忄 亶
暺	日 單
醓	酉 冘 皿
璮	玉 亶	王 亶
襢	衣 亶	衤 亶
叹	口 又
炭	山 灰	山 厂 火
埮	土 炎
探	手 罙	扌 罙	才 罙
傝	人 日 羽	亻 日 羽
湠	水 炭	氵 炭
僋	人 貪	亻 貪
嘆	口 革 大
碳	石 炭
舕	舌 炎
歎	革 大 欠
賧	貝 炎
汤	水 弓 丿 丿	氵 弓 丿 丿
铴	金 汤	钅 汤
湯	水 昜	氵 昜
嘡	口 堂
耥	耒 尚
劏	當 刀	當 刂
羰	羊 炭
蝪	蟲 昜	虫 昜
薚	草 歹 昜	艸 歹 昜	艹 歹 昜
镗	金 堂	钅 堂
蹚	足 堂
鏜	金 堂	釒 堂
鐋	金 湯	釒 湯
鼞	鼓 堂
饧	饣 弓 丿 丿
坣	小 冖 土	丷 宀 土
唐	广 肀 口	广 聿 口
堂	尚 土
傏	人 唐	亻 唐
啺	口 昜
棠	尚 木
鄌	唐 邑	唐 阝
塘	土 唐
搪	手 唐	扌 唐	才 唐
溏	水 唐	氵 唐
蓎	草 唐	艸 唐	艹 唐
隚	阜 堂	阝 堂
榶	木 唐
漟	水 堂	氵 堂
煻	火 唐
瑭	玉 唐	王 唐
禟	示 唐	礻 唐
膅	肉 唐	月 唐
樘	木 堂
磄	石 唐
糃	米 昜
膛	肉 堂	月 堂
橖	木 棠
篖	竹 唐
糖	米 唐
螗	虫 唐
螗	蟲 唐	虫 唐
踼	足 昜
糛	米 堂
螳	虫 堂
螳	蟲 堂	虫 堂
赯	赤 唐
醣	酉 唐
餳	食 昜
鎕	金 唐	釒 唐
餹	食 唐
闛	門 堂
饄	食 堂
鶶	唐 鳥
伖	人 友	亻 友
帑	奴 巾
倘	人 尚	亻 尚
偒	人 易	亻 易
淌	水 尚	氵 尚
傥	人 党	亻 党
躺	身 尚
镋	金 党	钅 党
鎲	金 党	釒 党
儻	人 黨	亻 黨
戃	心 黨	忄 黨
曭	日 黨
爣	火 黨
矘	目 黨
钂	金 黨	釒 黨
烫	汤 火
摥	手 丿 一 昜	扌 丿 一 昜	才 丿 一 昜
趟	走 尚
燙	湯 火
夲	大 十
弢	弓 山 又	弓 屮 又
涛	水 寿	氵 寿
绦	丝 条	纟 条
掏	手 匋	扌 匋	才 匋
絛	攸 糸
詜	言 山 又	訁 山 又	訁 屮 又
嫍	女 舀
幍	巾 舀
慆	心 舀	忄 舀
搯	手 舀	扌 舀	才 舀
滔	水 舀	氵 舀
槄	木 舀
瑫	玉 舀	王 舀
韬	韦 舀
飸	号 食
縚	絲 舀	糹 舀	糸 舀
縧	絲 條	糹 條	糸 條
濤	水 壽	氵 壽
謟	言 舀	訁 舀
轁	車 舀
鞱	革 舀
韜	韋 舀
饕	號 食
匋	勹 缶
迯	辵 外	辶 外
咷	口 兆
洮	水 兆	氵 兆
逃	辵 兆	辶 兆
桃	木 兆
陶	阜 匋	阝 匋
啕	口 匋
梼	木 寿
淘	水 匋	氵 匋
绹	丝 匋	纟 匋
萄	草 匋	艸 匋	艹 匋
祹	示 匋	礻 匋
裪	衣 匋	衤 匋
綯	絲 匋	糹 匋	糸 匋
蜪	虫 匋
蜪	蟲 匋	虫 匋
鞀	革 召
醄	酉 匋
鞉	革 兆
鋾	金 匋	釒 匋
錭	金 周	釒 周
駣	馬 兆
檮	木 壽
饀	食 舀
騊	馬 匋
鼗	兆 鼓
讨	言 寸	讠 寸
討	言 寸	訁 寸
套	大 镸
忑	下 心
忒	弋 心
特	牛 寺	牜 寺
貣	弋 貝
铽	金 忒	钅 忒
慝	匿 心
鋱	金 忒	釒 忒
螣	丷 夫 虫	𠔉 虫
螣	丷 夫 蟲	丷 夫 虫	𠔉 蟲
蟘	蟲 貸	虫 貸
熥	火 通
膯	肉 登	月 登
鼟	鼓 登
疼	病 冬	疒 冬
痋	病 虫	疒 虫
痋	病 蟲	疒 蟲	疒 虫
幐	肉 丷 夫 巾	月 丷 夫 巾	肉 𠔉 巾	月 𠔉 巾
腾	肉 丷 夫 马	月 丷 夫 马	肉 𠔉 马	月 𠔉 马
誊	丷 夫 言	𠔉 言
漛	水 丷 夫 水	氵 丷 夫 水	水 𠔉 水
漛	水 丷 夫 水	氵 丷 夫 水	水 𠔉 水	氵 𠔉 水
滕	水 丷 夫 水	氵 丷 夫 水	水 𠔉 水	氵 𠔉 水
邆	辵 登	辶 登
縢	肉 絭	月 絭
駦	丷 夫 馬	𠔉 馬
謄	月 誊
儯	人 駦	亻 駦
藤	草 滕	艸 滕	艹 滕
騰	肉 駦	月 駦
籐	竹 滕
鰧	肉 鮝	月 鮝
籘	竹 縢
驣	馬 駦
霯	雨 登
剔	易 刀	易 刂
梯	木 弟
锑	金 弟	钅 弟
踢	足 易
擿	手 適	扌 適	才 適
鷈	鳥 虒
鷉	虒 鳥
苐	草 弔	艸 弔	艹 弔
厗	厂 辛
荑	草 夷	艸 夷	艹 夷
绨	丝 弟	纟 弟
偍	人 是	亻 是
啼	口 帝
崹	山 帝
惿	心 是	忄 是
提	手 是	扌 是	才 是
稊	禾 弟
缇	丝 是	纟 是
罤	网 弟	罒 弟
遆	辵 帝	辶 帝
鹈	弟 鸟
嗁	口 虒
瑅	玉 是	王 是
綈	絲 弟	糹 弟	糸 弟
碮	石 是
褆	衣 是	衤 是
徲	彳 犀
漽	水 犀	氵 犀
緹	絲 是	糹 是	糸 是
蕛	草 稊	艸 稊	艹 稊
蝭	虫 是
蝭	蟲 是	虫 是
銻	金 弟	釒 弟
题	是 页
趧	走 是
蹄	足 帝
醍	酉 是
謕	言 虒	訁 虒
蹏	足 虒
鍗	金 帝	釒 帝
鳀	鱼 是
鴺	夷 鳥
題	是 頁
鮷	魚 弟
鵜	弟 鳥
騠	馬 是
鯷	魚 是
鶗	是 鳥
鶙	帝 鳥
禵	示 題	礻 題
鷤	單 鳥
体	人 本	亻 本
挮	手 弟	扌 弟	才 弟
躰	身 本
骵	骨 本
鮧	魚 夷
軆	身 豐
體	骨 豊
戻	戶 大
戻	户 大
屉	尸 世
剃	弟 刀	弟 刂
洟	水 夷	氵 夷
倜	人 周	亻 周
悌	心 弟	忄 弟
涕	水 弟	氵 弟
逖	辵 狄	辶 狄
屜	尸 彳 世
悐	狄 心
惕	心 易	忄 易
掦	手 易	扌 易	才 易
逷	辵 易	辶 易
惖	易 心
揥	手 帝	扌 帝	才 帝
替	夫 夫 曰	夫 夫 日
楴	木 帝
裼	衣 易	衤 易
褅	衣 帝	衤 帝
歒	啇 欠
殢	歹 帶
髰	髟 髟 世
薙	草 雉	艸 雉	艹 雉
嚏	口 疐
鬀	髟 弟
嚔	口 十 冖 田 厶 卜 人
瓋	玉 適	王 適
籊	竹 翟
趯	走 翟
天	一 大
兲	王 八
婖	女 忝
添	水 忝	氵 忝
酟	酉 占
靔	青 气
黇	黃 占
靝	青 氣
田	囗 十
屇	尸 田
沺	水 田	氵 田
恬	心 舌	忄 舌
畋	田 攴	田 攵
畑	火 田
盷	目 勺
胋	肉 占	月 占
甛	甘 舌
甜	舌 甘
菾	草 忝	艸 忝	艹 忝
湉	水 恬	氵 恬
塡	土 眞
填	土 真
搷	手 真	扌 真	才 真
鈿	金 田	釒 田
阗	门 真
緂	絲 炎	糹 炎	糸 炎
磌	石 真
窴	穴 真
璳	玉 朱 貝	王 朱 貝
闐	門 真
鷆	眞 鳥
鷏	真 鳥
忝	天 心
殄	歹 人 彡
倎	人 典	亻 典
唺	口 典
悿	心 忝	忄 忝
淟	水 典	氵 典
晪	日 典
琠	玉 典	王 典
腆	肉 典	月 典
觍	典 见
痶	病 典	疒 典
睓	目 典
舔	舌 忝
餂	食 舌
覥	典 見
賟	貝 典
錪	金 典	釒 典
鍩	金 若	釒 若
靦	面 見
掭	手 忝	扌 忝	才 忝
睼	目 是
舚	舌 詹
旫	日 刀
佻	人 兆	亻 兆
庣	广 兆
恌	心 兆	忄 兆
挑	手 兆	扌 兆	才 兆
祧	示 兆	礻 兆
聎	耳 兆
芀	草 刀	艸 刀	艹 刀
条	夕 木	夂 木
岧	山 召
岹	山 召
迢	辵 召	辶 召
祒	示 召	礻 召
條	攸 木
笤	竹 召
萔	草 招	艸 招	艹 招
蓚	草 修	艸 修	艹 修
蓨	草 攸 月	艸 攸 月	艹 攸 月
趒	走 兆
龆	齿 召
樤	木 條
蜩	虫 周
蜩	蟲 周	虫 周
鋚	攸 金
鞗	攸 革
髫	髟 召
鲦	鱼 条
鯈	攸 魚
鎥	條 金
齠	齒 召
鰷	魚 條
宨	宀 兆
晀	日 兆
朓	月 兆
脁	肉 兆	月 兆
窕	穴 兆
誂	言 兆	訁 兆
斢	黃 斗
窱	穴 條
嬥	女 翟
眺	目 兆
粜	出 米
絩	絲 兆	糹 兆	糸 兆
覜	兆 見
跳	足 兆
糶	粜 翟
帖	巾 占
怗	心 占	忄 占
贴	贝 占
萜	草 帖	艸 帖	艹 帖
聑	耳 耳
貼	貝 占
铁	金 失	钅 失
蛈	虫 失
蛈	蟲 失	虫 失
僣	人 替	亻 替
銕	金 夷	釒 夷
鋨	金 我	釒 我
鴩	失 鳥
鐡	金 十 豆 戈	釒 十 豆 戈
鐵	金 哉 王	釒 哉 王	金 土 口 王 戈	釒 土 口 王 戈
驖	馬 哉 王
呫	口 占
飻	食 人 彡
餮	殄 食
厅	厂 丁
庁	广 丁
汀	水 丁	氵 丁
艼	草 丁	艸 丁	艹 丁
听	口 斤
町	田 丁
耓	耒 丁
厛	厂 听
烃	火 𢀖
桯	木 呈
烴	火 巠
綎	絲 廷	糹 廷	糸 廷
鞓	革 呈
聴	耳 十 目 心
聼	乛 耳 十 目 一 心
廰	广 聴
聽	耳 王 十 目 一 心
廳	广 聽
邒	丁 邑	丁 阝
廷	廴 壬
亭	亠 口 冖 丁
庭	广 廷
莛	草 廷	艸 廷	艹 廷
停	人 亭	亻 亭
婷	女 亭
嵉	山 亭
渟	水 亭	氵 亭
筳	竹 廷
葶	草 亭	艸 亭	艹 亭
蜓	虫 廷
蜓	蟲 廷	虫 廷
楟	木 亭
榳	木 庭
閮	門 廷
霆	雨 廷
聤	耳 亭
蝏	虫 亭
蝏	蟲 亭	虫 亭
諪	言 亭	訁 亭
鼮	鼠 廷
圢	土 丁
甼	田 丁
侹	人 廷	亻 廷
娗	女 廷
挺	手 廷	扌 廷	才 廷
涏	水 廷	氵 廷
梃	木 廷
烶	火 廷
珽	玉 廷	王 廷
脡	肉 廷	月 廷
艇	舟 廷
颋	廷 页
誔	言 廷	訁 廷
頲	廷 頁
囲	囗 井
炵	火 冬
通	辵 甬	辶 甬
痌	病 同	疒 同
嗵	口 通
蓪	草 通	艸 通	艹 通
樋	木 通
仝	人 工
同	冂 一 口
佟	人 冬	亻 冬
彤	丹 彡
峂	山 冬
庝	广 冬
哃	口 同
峝	山 同
狪	犬 同	犭 同
茼	草 同	艸 同	艹 同
晍	日 同
桐	木 同
浵	水 彤	氵 彤
烔	火 同
砼	石 仝
蚒	虫 丹
蚒	蟲 丹	虫 丹
眮	目 同
秱	禾 同
铜	金 同	钅 同
童	立 里
粡	米 同
筩	竹 甬
詷	言 同	訁 同
赨	赤 虫
赨	赤 蟲	赤 虫
酮	酉 同
鉖	金 冬	釒 冬
僮	人 童	亻 童
勭	童 力
鉵	金 蟲	釒 蟲	金 虫	釒 虫
銅	金 同	釒 同
餇	食 同
鲖	鱼 同
潼	水 童	氵 童
獞	犬 童	犭 童
曈	日 童
朣	月 童
橦	木 童
氃	童 毛
燑	火 童
犝	牛 童	牜 童
膧	肉 童	月 童
瞳	目 童
鮦	魚 同
统	丝 充	纟 充
捅	手 甬	扌 甬	才 甬
桶	木 甬
筒	竹 同
統	絲 充	糹 充	糸 充
綂	絲 亠 兄	糹 亠 兄	糸 亠 兄
恸	心 动	忄 动
痛	病 甬	疒 甬
衕	行 同	彳 同 亍
慟	心 動	忄 動
憅	動 心
偷	人 俞	亻 俞
偸	人 兪	亻 兪
婾	女 俞
媮	女 俞
鋀	金 豆	釒 豆
鍮	金 俞	釒 俞
亠	丶 一
头	丶 丶 大
投	手 殳	扌 殳	才 殳
骰	骨 殳
緰	絲 俞	糹 俞	糸 俞
頭	豆 頁
妵	女 主
钭	金 斗	钅 斗
紏	絲 斗	糹 斗	糸 斗
敨	咅 攴	咅 攵
飳	食 主
黈	黄 主
黈	黃 主
蘣	草 黈	艸 黈	艹 黈
透	辵 秀	辶 秀
綉	絲 秀	糹 秀	糸 秀
凸	凵 一 丨 乛 
宊	宀 犬
禿	禾 儿
秃	禾 几
怢	心 失	忄 失
突	穴 犬
唋	口 余
涋	水 宊	氵 宊
捸	手 隶	扌 隶	才 隶
堗	土 突
湥	水 突	氵 突
痜	病 禿	疒 禿
葖	草 突	艸 突	艹 突
嶀	山 雩
鋵	金 禿	釒 禿
鵚	禿 鳥
鼵	鼠 突
図	囗 乂 丶 丶
图	囗 冬
凃	冰 余	冫 余
峹	余 山
庩	广 余
徒	彳 走
悇	心 余	忄 余
捈	手 余	扌 余	才 余
涂	水 余	氵 余
涂	水 余	氵 余 土 塗	氵 余
荼	草 余	艸 余	艹 余
途	辵 余	辶 余
屠	尸 者
梌	木 余
菟	草 兔	艸 兔	艹 兔
揬	手 突	扌 突	才 突
稌	禾 余
塗	涂 土	水 余 土
嵞	余 山 山
瘏	病 者	疒 者
筡	竹 余
腯	肉 盾	月 盾
蒤	草 涂	艸 涂	艹 涂
鈯	金 出	釒 出
圖	囗 啚
圗	囗 厶 面
廜	广 屠
潳	水 屠	氵 屠
跿	足 走
酴	酉 余
馟	香 孚
鍎	金 盾	釒 盾
駼	馬 余
鵌	余 鳥
鶟	突 鳥
鷋	荼 鳥
鷵	屠 鳥
土	十 一
圡	土 丶
吐	口 土
钍	金 土	钅 土
釷	金 土	釒 土
兎	丿 丨 口 儿 丶
兔	刀 口 丨 儿 丶
堍	土 兔
鵵	兔 鳥
湍	水 耑	氵 耑	水 山 而	氵 山 而
猯	犬 耑	犭 耑
煓	火 耑
貒	豸 耑
团	囗 才
団	囗 寸
抟	手 专	扌 专
剸	專 刀	專 刂
團	囗 專
慱	心 專	忄 專
摶	手 專	扌 專	才 專
漙	水 專	氵 專
槫	木 專
篿	竹 專
鏄	金 專	釒 專
糰	米 團
鷒	專 鳥
鷻	鳥 敦
疃	田 童
彖	彑 豕
褖	衣 彖	衤 彖
推	手 隹	扌 隹	才 隹
蓷	草 推	艸 推	艹 推
藬	草 隤	艸 隤	艹 隤
弚	八 弔
颓	秃 页
隤	阜 貴	阝 貴
尵	尢 貴
頹	禿 頁
頺	秀 頁
頽	秃 頁
魋	鬼 隹
穨	禿 貴
蘈	草 頹	艸 頹	艹 頹
蹪	足 貴
俀	人 妥	亻 妥
腿	肉 退	月 退
僓	人 貴	亻 貴
蹆	足 退
骽	骨 妥
侻	人 兌	亻 兌
退	辵 艮	辶 艮
娧	女 兌	女 兑
煺	火 退
蛻	蟲 兌	虫 兌
蜕	虫 兑
褪	衣 退	衤 退
駾	馬 兌
吞	天 口
呑	夭 口
旽	日 屯
涒	水 君	氵 君
啍	口 享
朜	月 享
焞	火 享
噋	口 敦
暾	日 敦
黗	黑 屯
屯	丿 凵 乚
坉	土 屯
忳	心 屯	忄 屯
芚	草 屯	艸 屯	艹 屯
饨	食 屯	饣 屯
豘	豕 屯
豚	肉 豕	月 豕
軘	車 屯
飩	食 屯	飠 屯
鲀	鱼 屯
魨	魚 屯
霕	雲 屯
臀	肉 殿	月 殿
臋	殿 肉	殿 月
氽	人 水
畽	田 重
乇	丿 七
仛	人 乇	亻 乇
讬	言 乇	讠 乇
托	手 乇	扌 乇	才 乇
扡	手 也	扌 也	才 也
汑	水 乇	氵 乇
饦	饣 乇
杔	木 乇
侂	人 广 乇	亻 广 乇
咃	口 他
拕	手 它	扌 它	才 它
拖	手 丿 一 也	扌 丿 一 也	才 丿 一 也
沰	水 石	氵 石
挩	手 兌	扌 兌	才 兌
捝	手 兑	扌 兑
莌	草 兌	艸 兌	艹 兌
莌	草 兑	艸 兑	艹 兑
託	言 乇	訁 乇
涶	水 垂	氵 垂
脫	肉 兌	月 兌
脱	肉 兑	月 兑
飥	食 乇
魠	魚 乇
驝	馬 槖
驮	马 大
佗	人 它	亻 它
陀	阜 它	阝 它
陁	阜 丿 一 也	阝 丿 一 也
坨	土 它
岮	山 它
沱	水 它	氵 它
沲	水 丿 一 也	氵 丿 一 也
狏	犬 丿 一 也	犭 丿 一 也
迱	辵 它	辶 它
驼	马 它
砣	石 它
砤	石 丿 一 也
袉	衣 它	衤 它
鸵	鸟 它
紽	絲 它	糹 它	糸 它
堶	土 左 月
跎	足 它
酡	酉 它
碢	石 咼
馱	馬 大
槖	士 冖 石 木
駄	馬 太
駝	馬 它
駞	馬 丿 一 也
橐	一 中 冖 木 石
鮀	魚 它
鴕	鳥 它
鼧	鼠 它
騨	馬 单 丶
鼍	口 口 田 一 黾	嘼 电
驒	馬 單
鼉	口 口 田 一 黽
彵	彳 也
妥	爪 女	爫 女
庹	广 廿 尺
媠	女 左 月
椭	木 隋 橢
楕	木 左 月
嫷	女 隋
橢	木 隋
鵎	妥 鳥
鬌	髟 左 月
鰖	魚 左 月
柝	木 拆
毤	兊 毛
唾	口 垂
萚	草 择	艸 择	艹 择
跅	足 斥
毻	左 月 毛
箨	竹 择
蘀	草 擇	艸 擇	艹 擇
籜	竹 擇
穵	穴 乙
劸	圭 力
挖	手 穵	扌 穵	才 穵	手 穴 乙
洼	水 圭	氵 圭
娲	女 呙	女 口 内
畖	田 瓜
窊	穴 瓜
媧	女 咼
嗗	口 骨
蛙	虫 圭
蛙	蟲 圭	虫 圭
搲	手 穴 瓜	扌 窊	才 窊
溛	水 窊	氵 窊
漥	水 穴 圭	氵 穴 圭
窪	穴 洼	穴 水 圭	穴 氵 圭
鼃	圭 黽
攨	手 穴 瓜 瓜 瓜	扌 穴 瓜 瓜 瓜	才 穴 瓜 瓜 瓜
娃	女 圭	女 土 土
瓦	一 𠄌 乙 丶
佤	人 瓦	亻 瓦
邷	瓦 邑	瓦 阝
咓	口 瓦
砙	石 瓦
袜	衣 末	衤 末
聉	耳 出
嗢	口 昷
腽	肉 昷	月 昷
膃	肉 昷	月 昷
襪	衣 蔑	衤 蔑
韈	革 蔑
韤	韋 蔑
哇	口 圭	口 土 土
歪	不 正
喎	口 咼
竵	立 鬲 匚 丨	立 一 口 匚 丨 冂 丷 丅
崴	山 威
外	夕 卜
顡	豙 頁
弯	亦 弓
剜	宛 刀	宛 刂
婠	女 官
帵	巾 宛
塆	土 弯
湾	水 弯	氵 弯
蜿	虫 宛
蜿	蟲 宛	虫 宛
潫	水 絭	氵 絭
豌	豆 宛
彎	絲 言 弓	糹 言 糹 弓	䜌 弓
灣	水 彎	氵 水 彎
丸	丶 九
刓	元 刀	元 刂
汍	水 丸	氵 丸
纨	丝 丸	纟 丸
芄	草 丸	艸 丸	艹 丸
完	宀 元
岏	山 元
抏	手 元	扌 元	才 元
玩	玉 元	王 元
紈	絲 丸	糹 丸	糸 丸
捖	手 完	扌 完	才 完
顽	元 页
烷	火 完
琓	玉 完	王 完
貦	貝 元
頑	元 頁
翫	習 元
宛	宀 夗
倇	人 宛	亻 宛
唍	口 完
挽	手 免	扌 免	才 免
盌	夗 皿
埦	土 宛
婉	女 宛
惋	心 宛	忄 宛
晚	日 免
晥	日 完
梚	木 免
绾	丝 官	纟 官
脘	肉 完	月 完
菀	草 宛	艸 宛	艹 宛
萖	草 兒	艸 兒	艹 兒
晩	日 免
晼	日 宛
椀	木 宛
琬	玉 宛	王 宛
皖	白 完
畹	田 宛
睕	目 宛
碗	石 宛
綩	絲 宛	糹 宛	糸 宛
綰	絲 官	糹 官	糸 官
輓	車 免
踠	足 宛
鋔	金 免	釒 免
万	一 勹	一 刀
卍	乛 乛
妧	女 元
忨	心 元	忄 元
捥	手 宛	扌 宛	才 宛
脕	肉 免	月 免
萬	草 禺	艸 禺	艹 禺
腕	肉 宛	月 宛
輐	車 完
澫	水 萬	氵 萬
鋄	金 灭 又	釒 灭 又
薍	草 亂	艸 亂	艹 亂
錽	金 灭 夕	釒 灭 夂
蟃	虫 曼
蟃	蟲 曼	虫 曼
贃	貝 患
鎫	金 丶 冂 乂 八 夕	釒 丶 冂 乂 八 夂
贎	貝 萬
尣	八 儿
尪	尢 王
尫	兀 王
汪	水 王	氵 王
尩	尣 王
亡	丶 匚	丶 一 乛
亾	丨 一 人
兦	丨 一 入
王	一 土	一 一 丨 一	二 十	三 丨	二 丄
仼	人 王	亻 王
彺	彳 王
莣	草 忘	艸 忘	艹 忘
蚟	虫 王
蚟	蟲 王	虫 王
罒	冖 丨 丨 一
网	冂 乂 乂
往	彳 主
徃	彳 生
枉	木 王
罔	冂 丷 一 亡
徍	彳 圭
惘	心 罔	忄 罔
菵	草 罔	艸 罔	艹 罔
暀	日 往
棢	木 罔
蛧	虫 网
辋	车 罔
網	絲 罔	糹 罔	糸 罔
蝄	蟲 罔	虫 罔
誷	言 罔	訁 罔
輞	車 罔
瀇	水 廣	氵 廣
魍	鬼 罔
妄	亡 女
忘	亡 心
迋	辵 王	辶 王
旺	日 王
盳	目 亡
望	亡 月 王
朢	臣 月 壬
危	厃 卩	刀 厂 卩	厃 㔾	刀 厂 㔾
威	戊 一 女
烓	火 圭
偎	人 畏	亻 畏
萎	草 委	艸 委	艹 委
逶	辵 委	辶 委
隇	阜 威	阝 威
隈	阜 畏	阝 畏
喴	口 威
媙	女 威
愄	心 畏	忄 畏
揋	手 畏	扌 畏	才 畏
渨	水 畏	氵 畏
葨	草 畏	艸 畏	艹 畏
葳	草 威	艸 威	艹 威
微	彳 山 兀 攴	彳 山 兀 攵
椳	木 畏
楲	木 威
溦	水 山 兀 攴	氵 山 兀 攵
煨	火 畏
詴	言 有	訁 有
蜲	虫 委
蜲	蟲 委	虫 委
蝛	虫 威
蝛	蟲 威	虫 威
覣	委 見
薇	草 微	艸 微	艹 微
燰	火 愛
鳂	鱼 畏
巍	山 魏
鰃	魚 畏
鰄	魚 威
囗	冂 一	丨 乛 一
韦	二 乛 丨
圩	土 于
围	囗 韦
帏	巾 韦
沩	水 为	氵 为
违	辵 韦	辶 韦
闱	门 韦
峗	山 危
峞	山 危
洈	水 危	氵 危
韋	彑 口 二 丶 丨
桅	木 危
涠	水 围	氵 围
唯	口 隹
帷	巾 隹
惟	心 隹	忄 隹
硙	石 岂
维	丝 隹	纟 隹
喡	口 韋
圍	囗 韋
媁	女 韋
嵬	山 鬼
幃	巾 韋
湋	水 韋	氵 韋
溈	水 為	氵 為
琟	玉 隹	王 隹
違	辵 韋	辶 韋
潍	水 维	氵 维
維	絲 隹	糹 隹	糸 隹
蓶	草 唯	艸 唯	艹 唯
鄬	為 邑	為 阝
潙	水 爲	氵 爲
潿	水 圍	氵 圍
磑	石 豈
醀	酉 隹
濰	水 維	氵 維
鍏	金 韋	釒 韋
闈	門 韋
鮠	魚 危
癓	病 微	疒 微
覹	見 微
犩	魏 牛
霺	雨 微
欈	木 巂
厃	刀 厂
伟	人 韦	亻 韦
伪	人 为	亻 为
尾	尸 毛
纬	丝 韦	纟 韦
芛	草 尹	艸 尹	艹 尹
苇	草 韦	艸 韦	艹 韦
委	禾 女
炜	火 韦
玮	玉 韦	王 韦
洧	水 有	氵 有
娓	女 尾
浘	水 尾	氵 尾
荱	草 尾	艸 尾	艹 尾
诿	言 委	讠 委
偉	人 韋	亻 韋
偽	人 為	亻 為
崣	山 委
梶	木 尾
痏	病 有	疒 有
硊	石 危
骩	骨 九
嵔	山 畏
徫	彳 韋
愇	心 韋	忄 韋
猥	犬 畏	犭 畏
葦	草 韋	艸 韋	艹 韋
蒍	草 為	艸 為	艹 為
骪	骨 凡
骫	骨 丸
暐	日 韋
椲	木 韋
煒	火 韋
瑋	玉 韋	王 韋
痿	病 委	疒 委
腲	肉 畏	月 畏
艉	舟 尾
韪	是 韦
僞	人 爲	亻 爲
撱	手 隋	扌 隋	才 隋
磈	石 鬼
鲔	鱼 有
寪	宀 為
緯	絲 韋	糹 韋	糸 韋
蔿	草 爲	艸 爲	艹 爲
諉	言 委	訁 委
踓	足 隹
韑	光 韋
頠	危 頁
薳	草 遠	艸 遠	艹 遠
儰	人 蒍	亻 蒍
濻	水 隤	氵 隤
鍡	金 畏	釒 畏
鮪	魚 有
壝	土 遺
瀢	水 遺	氵 遺
韙	是 韋
颹	風 韋
韡	韋 華
斖	文 臼 同 冖 且
卫	卩 一
为	丶 丿 乛 丶
未	一 木
位	人 立	亻 立
味	口 未
苿	草 未	艸 未	艹 未
為	丶 丿 乛 乛 乛 火	丶 丿 乛 乛 乛 灬
畏	田 一 衣
胃	田 肉	田 月
叞	尸 示 又
軎	車 口
尉	尸 示 寸
菋	草 味	艸 味	艹 味
谓	言 胃	讠 胃
喂	口 畏
媦	女 胃
渭	水 胃	氵 胃
爲	爪 乛 乛 乛 火 丿	爫 乛 乛 乛 灬 丿
猬	犬 胃	犭 胃
煟	火 胃
碨	石 畏
蔚	草 尉	艸 尉	艹 尉
蜼	虫 隹
蜼	蟲 隹	虫 隹
慰	尉 心
熭	彗 火
犚	尉 牛
緭	絲 胃	糹 胃	糸 胃
蝟	蟲 胃	虫 胃
衛	行 韋	彳 韋 亍
懀	心 會	忄 會
璏	玉 彘	王 彘
罻	网 尉	罒 尉
衞	行 乛 丨 一 口 币	行 乛 丨 一 口 帀
謂	言 胃	訁 胃
餧	食 委
鮇	魚 未
螱	尉 虫
螱	尉 蟲	尉 虫
褽	尉 衣
餵	食 畏	飠 畏
魏	委 鬼
藯	草 慰	艸 慰	艹 慰
轊	車 彗
鏏	金 彗	釒 彗
霨	雨 尉
鳚	鱼 尉
蘶	草 魏	艸 魏	艹 魏
饖	食 歲
讆	衛 言
躗	衛 足
讏	衞 言
躛	衞 足
昷	日 皿
塭	土 昷
温	水 昷	氵 昷
榅	木 昷
殟	歹 昷
溫	水 昷	氵 昷
瑥	玉 昷	王 昷
辒	车 昷
榲	木 囚 皿	木 昷
瘟	病 昷	疒 昷
蕰	草 温	艸 温	艹 温
豱	豕 昷
輼	車 昷
轀	車 昷
饂	食 昷
鳁	鱼 昷
鰛	魚 昷
鰮	魚 昷
文	亠 乂
彣	丶 又 彡
纹	丝 文	纟 文
芠	草 文	艸 文	艹 文
炆	火 文
玟	玉 文	王 文
闻	门 耳
紋	絲 文	糹 文	糸 文
蚉	文 虫
蚉	文 蟲	文 虫
蚊	虫 文
蚊	蟲 文	虫 文
珳	玉 彣	王 彣
阌	门 受
雯	雨 文
瘒	病 軍	疒 軍
聞	門 耳
馼	馬 文
魰	魚 文
鳼	文 鳥
鴍	文 鳥
螡	文 虫 虫
螡	文 蟲 蟲	文 虫 虫
閺	門 旻
閿	門 受
蟁	民 虫 虫
蟁	民 蟲 蟲	民 虫 虫
闅	門 目 攴
鼤	鼠 文
闦	門 豊
刎	勿 刀	勿 刂
吻	口 勿
忟	心 文	忄 文
抆	手 文	扌 文	才 文
呡	口 民
肳	肉 勿	月 勿
紊	文 丝	文 糸
紊	文 絲	文 糸
桽	木 坐
脗	肉 勿 口	月 勿 口
稳	禾 急
穏	禾 爪 彐 心	禾 爫 彐 心
穩	禾 爪 工 彐 心	禾 爫 工 彐 心	禾 㥯
问	门 口
妏	女 文
汶	水 文	氵 文
莬	草 免	艸 免	艹 免
問	門 口
渂	水 旻	氵 旻
揾	手 昷 搵	扌 昷 搵	才 昷 搵
搵	手 昷	扌 昷	才 昷
顐	軍 頁
璺	臼 同 冖 玉
翁	公 羽
嗡	口 翁
滃	水 翁	氵 翁
鹟	翁 鸟
螉	虫 翁
螉	蟲 翁	虫 翁
鎓	金 翁	釒 翁
鶲	翁 鳥
勜	翁 力
奣	天 明
塕	土 翁
嵡	山 翁
蓊	草 翁	艸 翁	艹 翁
暡	日 翁
瞈	目 翁
聬	耳 翁
瓮	公 瓦
蕹	草 雍	艸 雍	艹 雍
甕	雍 瓦
罋	雍 缶
齆	鼻 邕
挝	手 过	扌 过	才 过
倭	人 委	亻 委
涡	水 呙	氵 呙	水 口 内
莴	草 呙	艸 呙	艹 呙	草 口 内
唩	口 委
涹	水 委	氵 委
渦	水 咼	氵 咼
猧	犬 咼	犭 咼
萵	草 咼	艸 咼	艹 咼
窝	穴 呙	穴 口 内
窩	穴 咼
蜗	虫 呙	虫 口 内
撾	手 過	扌 過	才 過
蝸	蟲 咼	虫 咼
踒	足 委
我	手 戈	扌 戈	才 戈
婐	女 果
捰	手 果	扌 果	才 果
仴	人 月	亻 月
沃	水 夭	氵 夭
肟	肉 亏	月 亏
卧	臣 卜
枂	木 月
臥	臣 人
偓	人 屋	亻 屋
捾	手 官	扌 官	才 官
涴	水 宛	氵 宛
媉	女 屋
幄	巾 屋
握	手 屋	扌 屋	才 屋
渥	水 屋	氵 屋
焥	火 宛
硪	石 我
楃	木 屋
腛	肉 屋	月 屋
斡	十 日 十 人 斗
瞃	目 盾
擭	手 蒦	扌 蒦	才 蒦
濣	水 斡	氵 斡
瓁	玉 蒦	王 蒦
臒	肉 蒦	月 蒦
雘	丹 蒦
龌	齿 屋
齷	齒 屋
乌	勹 乛 一
圬	土 亏
弙	弓 于
汙	水 于	氵 于
汚	水 亐	氵 亐
污	水 亏	氵 亏
邬	乌 邑	乌 阝
呜	口 乌
巫	工 人 人
杇	木 亏
屋	尸 至
洿	水 夸	氵 夸
诬	言 巫	讠 巫
钨	金 乌	钅 乌
烏	户 一 乛 火	户 一 乛 灬
剭	屋 刀	屋 刂
窏	穴 汙
鄔	烏 邑	烏 阝
嗚	口 烏
誈	言 至	訁 至
歍	烏 欠
誣	言 巫	訁 巫
箼	竹 屋
螐	蟲 烏	虫 烏
鴮	夸 鳥
鎢	金 烏	釒 烏
鰞	魚 烏
无	一 尢
毋	𠃋 𠃌 一 丿
吳	口 乛 大
吴	口 天
吾	五 口
呉	口 乛 一 八
芜	草 无	艸 无	艹 无
郚	吾 邑	吾 阝
唔	口 吾
娪	女 吾
洖	水 吳	氵 吳
浯	水 吾	氵 吾
茣	草 吳	艸 吳	艹 吳
莁	草 巫	艸 巫	艹 巫
梧	木 吾
珸	玉 吾	王 吾
祦	示 吴	礻 吴
無	丿 一 卌 一 火	丿 一 卌 一 灬	丿 一 一 丨 丨 丨 丨 一 火
铻	金 吾	钅 吾
鹀	巫 乌
禑	示 禺	礻 禺
蜈	虫 吴
蜈	蟲 吳	虫 吳
蕪	草 無	艸 無	艹 無
璑	玉 無	王 無
蟱	蟲 無	虫 無
鯃	魚 吾
鵐	巫 鳥
譕	言 無	訁 無
鼯	鼠 吾
鷡	無 烏
五	二 丨 乛
午	丿 干
仵	人 午	亻 午
伍	人 五	亻 五
妩	女 无
庑	广 无
忤	心 午	忄 午
怃	心 无	忄 无
旿	日 午
武	一 弋 止
玝	玉 午	王 午
侮	人 每	亻 每
俉	人 吾	亻 吾
倵	人 武	亻 武
捂	手 吾	扌 吾	才 吾
啎	午 吾
娬	女 武
牾	牛 吾	牜 吾
珷	玉 武	王 武
摀	手 烏	扌 烏	才 烏
碔	石 武
鹉	武 鸟
熓	火 烏
瑦	玉 烏	王 烏
舞	丿 一 卌 一 舛	丿 一 一 丨 丨 丨 丨 一 舛
嫵	女 無
廡	广 無
憮	心 無	忄 無
潕	水 無	氵 無
儛	人 舞	亻 舞
橆	丿 一 卌 一 林
甒	無 瓦
鵡	武 鳥
躌	足 舞
兀	一 儿
勿	勹 丿 丿
务	夕 力	夂 力
戊	丿 戈
阢	阜 兀	阝 兀
伆	人 勿	亻 勿
屼	山 兀
扤	手 兀	扌 兀	才 兀
坞	土 乌
岉	山 勿
杌	木 兀
芴	草 勿	艸 勿	艹 勿
迕	辵 午	辶 午
忢	五 心
物	牛 勿	牜 勿
矹	石 兀
卼	兀 危
敄	矛 攴	矛 攵
误	言 吴	讠 吴
務	矛 务	矛 夂 力
悞	心 吳	忄 吳
悟	心 吾	忄 吾
悮	心 吴	忄 吴
粅	米 勿
逜	辵 吾	辶 吾
晤	日 吾
焐	火 吾
婺	敄 女
嵍	敄 山
痦	病 吾	疒 吾
隖	阜 烏	阝 烏
靰	革 兀
骛	敄 马
塢	土 烏
奦	務 大
奦	務 大	矛 务 大
嵨	山 烏
溩	水 烏	氵 烏
雺	雨 矛
雾	雨 务
寤	宀 爿 吾
熃	務 火
誤	言 吳	訁 吳
鹜	敄 鸟	矛 攵 鸟	矛 文 鸟
鋈	沃 金
窹	穴 爿 吾
霚	雨 敄
鼿	鼻 兀
霧	雨 務
齀	鼻 瓦
蘁	草 噩	艸 噩	艹 噩
騖	敄 馬
鶩	敄 鳥
夕	丿 丿 丶
兮	八 丂
吸	口 及
忚	心 也	忄 也
扱	手 及	扌 及	才 及
汐	水 夕	氵 夕
西	一 口 儿	一 囗 儿	一 四
覀	一 丨 丨 口
希	乂 布	乂 一 丿 巾
扸	手 片	扌 片	才 片
卥	卜 囪
昔	井 日
析	木 斤
穸	穴 夕
肸	肉 八 十	月 八 十
肹	肉 兮	月 兮
俙	人 希	亻 希
徆	彳 西
怸	术 心
恓	心 西	忄 西
郗	希 邑	希 阝
饻	饣 衣
唏	口 希
奚	爪 幺 大	爫 幺 大
屖	尸 辛
息	自 心
悕	心 希	忄 希
氥	气 西
氥	氣 西	气 西
浠	水 希	氵 希
牺	牛 西	牜 西
狶	犬 希	犭 希
莃	草 希	艸 希	艹 希
唽	口 析
悉	采 心	釆 心
惜	心 昔	忄 昔
晞	日 希
桸	木 希
欷	希 欠
淅	水 析	氵 析
烯	火 希
焈	戶 已	户 已
琋	玉 希	王 希
硒	石 西
菥	草 析	艸 析	艹 析
赥	赤 欠
釸	金 夕	釒 夕
傒	人 奚	亻 奚
惁	析 心
晰	日 析
晳	析 日
焟	火 昔
焬	火 易
犀	尸 二 丨 二 牛
睎	目 希
稀	禾 希
粞	米 西
翕	合 羽
翖	合 羽
舾	舟 西
鄎	息 邑	息 阝
厀	桼 卩
嵠	山 奚
徯	彳 奚
溪	水 奚	氵 奚
皙	析 白
蒠	草 息	艸 息	艹 息
锡	金 易	钅 易
僖	人 喜	亻 喜
榽	木 奚
煕	巸 火	巸 灬
熄	火 息
熈	丿 熙
熙	巸 火	巸 灬
緆	絲 易	糹 易	糸 易
蜥	虫 析
蜥	蟲 析	虫 析
豨	豕 希
餏	食 衣
嘻	口 喜
噏	口 翕
嬆	女 翕
嬉	女 喜
嶲	山 雋
潝	水 翕	氵 翕
瘜	病 息	疒 息
磎	石 奚
膝	肉 桼	月 桼
凞	冰 熙	冫 熙
憙	喜 心
樨	木 犀
橀	木 亠 厶 川 皿	木 巟 皿	木 㐬 皿
熹	喜 火	喜 灬
熺	火 喜
熻	火 翕
窸	穴 悉
縘	絲 奚	糹 奚	糸 奚
羲	羊 禾 丂 戈
螅	虫 息
螅	蟲 息	虫 息
螇	虫 奚
螇	蟲 奚	虫 奚
錫	金 易	釒 易
燨	火 義
瞦	目 喜
蟋	虫 悉
蟋	蟲 悉	虫 悉
谿	奚 谷
豀	谷 奚
豯	豕 奚
貕	豸 奚
糦	米 喜
繥	絲 喜	糹 喜	糸 喜
釐	未 攴 厂 里	未 攵 厂 里
雟	屮 隹 冏
鵗	希 鳥
觹	角 隽	角 隹 凹
觹	角 雋
譆	言 喜	訁 喜
醯	酉 亠 厶 川 皿	酉 巟 皿	酉 㐬 皿
鏭	金 悉	釒 悉
隵	阜 戲	阝 戲
巇	山 戲
曦	日 羲
爔	火 羲
犧	牛 羲	牜 羲
酅	巂 邑	巂 阝
觽	角 嶲
鼷	鼠 奚
蠵	虫 巂	虫 崔 冂 八 口	虫 崔 冏	虫 崔 冏
蠵	蟲 巂	虫 巂
鸂	水 鷄	氵 鷄
觿	角 巂
觿	角 巂	角 崔 囧
鑴	金 巂	釒 巂
习	刁 丶
郋	自 邑	自 阝
席	广 廿 巾
習	羽 白
袭	龙 衣
觋	巫 见
喺	口 係
媳	女 息
椺	木 保
蒵	草 奚	艸 奚	艹 奚
蓆	草 席	艸 席	艹 席
嶍	山 習
漝	水 習	氵 習
覡	巫 見
趘	走 尾
槢	木 習
薂	草 敫	艸 敫	艹 敫
隰	阜 日 幺 幺 火	阝 日 幺 幺 灬	阜 㬎	阝 㬎
檄	木 敫
謵	言 習	訁 習
鎴	金 息	釒 息
霫	雨 習
鳛	鱼 習
飁	習 風
騱	馬 奚
騽	馬 習
襲	龍 衣
鰼	魚 習
驨	馬 巂
枲	台 木
洗	水 先	氵 先
玺	尔 玉
徙	彳 歨	彳 止 疋
铣	金 先	钅 先
喜	士 口 丷 一 口
葈	草 枲	艸 枲	艹 枲	苔 木
葸	草 思	艸 思	艹 思
鈢	金 木	釒 木
鉨	金 尔	釒 尔
鉩	金 尒	釒 尒
屣	尸 徙
漇	水 徙	氵 徙
蓰	草 徙	艸 徙	艹 徙
憘	心 喜	忄 喜
暿	日 喜
歖	喜 欠
禧	示 喜	礻 喜
諰	言 思	訁 思
壐	爾 土
縰	絲 徙	糹 徙	糸 徙
謑	言 奚	訁 奚
蟢	虫 喜
蟢	蟲 喜	虫 喜
蹝	足 徙
璽	爾 玉
囍	喜 喜	士 口 丷 一 口 士 口 丷 一 口
鱚	魚 喜
矖	目 麗
躧	足 麗
卌	丿 丨 丨 丨 丨 一	川 丨 一
戏	又 戈
屃	尸 贝
系	丿 糸	丿 幺 小
系	丿 幺 小	丿 幺 小
饩	食 气	饣 气
呬	口 四
忥	气 心
忥	氣 心	气 心
怬	心 四	忄 四
矽	石 夕
细	丝 田	纟 田
係	人 系	亻 系
咥	口 至
恄	心 吉	忄 吉
盻	目 兮
郤	谷 邑	谷 阝
欯	吉 欠
绤	丝 谷	纟 谷
細	絲 田	糹 田	糸 田
釳	金 乞	釒 乞
阋	门 兒
椞	析 木
舃	臼 一 勹 火 舄	臼 一 勹 灬 舄
舄	臼 勹 火	臼 勹 灬
趇	走 立
隙	阜 小 日 小	阝 小 日 小
慀	心 奚	忄 奚
滊	水 氣	氵 氣
禊	示 契	礻 契
綌	絲 谷	糹 谷	糸 谷
赩	赤 色
隟	阜 巢	阝 巢
墍	旣 土
熂	火 氣
犔	牛 氣	牜 氣
稧	禾 契
潟	水 臼 勹 火	氵 臼 勹 灬
澙	水 舃	氵 舃
蕮	草 舄	艸 舄	艹 舄
覤	虎 見
戱	虛 戈
黖	黑 旡
戲	虎 豆 戈	虍 豆 戈
磶	石 舄
虩	小 日 小 虎
餼	食 氣	飠 氣
鬩	鬥 兒
繫	車 凵 殳
嚱	口 戲
闟	門 翕
霼	雲 氣
屭	尸 贔
衋	聿 百 百 血
疨	病 牙	疒 牙
虾	虫 下
谺	谷 牙
傄	人 眘	亻 眘
閕	門 牙
煆	火 叚
颬	風 牙
瞎	目 害
蝦	蟲 叚	虫 叚
鰕	魚 叚
匣	匚 甲
侠	人 夹	亻 夹
狎	犬 甲	犭 甲
俠	人 夾	亻 夾
叚	尸 二 又
峡	山 夹
柙	木 甲
炠	火 甲
狭	犬 夹	犭 夹
陜	阜 夾	阝 夾
峽	山 夾
烚	火 合
狹	犬 夾	犭 夾
珨	玉 合	王 合
祫	示 合	礻 合
硖	石 夹
翈	甲 羽
舺	舟 甲
陿	阜 匧	阝 匧
硤	石 夾
遐	辵 叚	辶 叚
敮	臿 攴
暇	日 叚
瑕	玉 叚
筪	竹 匣
舝	土 巛 冖 牟
碬	石 叚
辖	车 害
磍	石 害
縀	絲 叚	糹 叚	糸 叚
蕸	草 遐	艸 遐	艹 遐
縖	絲 害	糹 害	糸 害
赮	赤 叚
魻	魚 甲
轄	車 害
鍜	金 叚	釒 叚
霞	雨 叚
鎋	金 害	釒 害
黠	黑 吉
騢	馬 叚
鶷	害 鳥
閜	門 可
丅	一 丨
下	一 卜	一 丨 丶
吓	口 下
疜	病 下	疒 下
夏	一 自 夕	一 自 夂
睱	目 叚
嚇	口 赫
懗	心 赫	忄 赫
罅	缶 虖
夓	夏 夂
鏬	金 虖	釒 虖
仙	人 山	亻 山
仚	人 山
屳	入 山
先	丿 土 儿
奾	女 山
纤	丝 千	纟 千
佡	人 仚	亻 仚
忺	心 欠	忄 欠
氙	气 山
氙	氣 山	气 山
杴	木 欠
祆	示 天	礻 天
秈	禾 山
苮	草 仙	艸 仙	艹 仙
枮	木 占
籼	米 山
珗	玉 先	王 先
莶	草 佥	艸 佥	艹 佥
掀	手 欣	扌 欣	才 欣
铦	金 舌	钅 舌
跹	足 迁
酰	酉 先
锨	金 欣	钅 欣
僊	人 西 大 己	亻 覀 大 己
嘕	口 焉
銛	金 舌	釒 舌
鲜	鱼 羊
暹	日 進
韯	十 戈 韭	𢦏 韭
嬐	女 佥
嬐	女 僉
憸	心 僉	忄 僉
薟	草 僉	艸 僉	艹 僉
鍁	金 欣	釒 欣
褼	衣 西 大 己	衤 西 大 己	衣 覀 大 己	衤 覀 大 己
韱	人 人 戈 韭
鮮	魚 羊
蹮	足 西 大 己	足 覀 大 己
馦	香 兼
廯	广 鮮
攕	手 韱	扌 韱	才 韱
纎	絲 韯	糹 韯	糸 韯
鶱	宀 井 大 鳥
襳	衣 韱	衤 韱
躚	足 遷
纖	絲 韱	糹 韱	糸 韱
鱻	魚 魚 魚
伭	人 玄	亻 玄
闲	门 木
妶	女 玄
弦	弓 玄
贤	丨 丨 又 贝
咸	戊 一 口
唌	口 延
挦	手 寻	扌 寻
涎	水 延	氵 延
胘	肉 玄	月 玄
娴	女 闲
娹	女 弦
婱	弦 女
絃	絲 玄	糹 玄	糸 玄
舷	舟 玄
蚿	虫 玄
蚿	蟲 玄	虫 玄
衔	行 金	彳 金 亍	行 钅
啣	口 卸
湺	水 保	氵 保
痫	病 闲	疒 闲
蛝	虫 艮
蛝	蟲 艮	虫 艮
閑	門 木
閒	門 月
鹇	闲 鸟
嫌	女 兼
衘	行 午 止	彳 午 止 亍
甉	兼 瓦
銜	行 金	行 釒	彳 金 亍
嫺	女 閒
嫻	女 閑
憪	心 閒	忄 閒
撏	手 尋	扌 尋	才 尋
澖	水 閑	氵 閑
稴	禾 兼
誸	言 弦	訁 弦
賢	臤 貝
諴	言 咸	訁 咸
輱	車 咸
醎	酉 咸
癇	病 閒	疒 閒
癎	病 間	疒 間
瞯	目 閒
藖	草 賢	艸 賢	艹 賢
礥	石 賢
鹹	鹵 咸
麙	鹿 咸
贒	臣 忠 貝
鷳	閒 鳥
鷴	閑 鳥
鷼	間 鳥
冼	冰 先	冫 先
狝	犬 尔	犭 尔
显	日 业
险	阜 佥	阝 佥
崄	山 佥
毨	毛 先
烍	火 先
猃	犬 佥	犭 佥
蚬	虫 见
険	阜 人 一 口 人	阝 人 一 口 人
赻	走 少
筅	竹 先
尟	是 少
尠	甚 少
搟	手 軒	扌 軒	才 軒
禒	示 彖	礻 彖
跣	足 先
銑	金 先	釒 先
箲	竹 洗
險	阜 僉	阝 僉
嶮	山 僉
獫	犬 僉	犭 僉
獮	犬 爾	犭 爾
藓	草 鲜	艸 鲜	艹 鲜
鍌	洗 金
燹	豕 豕 火
顕	显 頁
幰	巾 憲
攇	手 憲	扌 憲	才 憲
櫶	木 憲
蘚	草 鮮	艸 鮮	艹 鮮
譣	言 僉	訁 僉
玁	犬 嚴	犭 嚴
韅	革 日 幺 幺 火	革 日 幺 幺 灬	革 㬎
顯	日 幺 幺 火 頁	日 幺 幺 灬 頁	㬎 頁
灦	水 顯	氵 顯
伣	人 见	亻 见
县	且 厶
咞	口 开
岘	山 见
苋	草 见	艸 见	艹 见
现	玉 见	王 见
线	丝 戋	纟 戋
臽	刀 臼
限	阜 艮	阝 艮
姭	劦 女
宪	宀 先
県	目 丨 一 小
陥	阜 刀 旧	阝 刀 旧
哯	口 見
垷	土 見
娊	女 見
娨	女 旱
峴	山 見
涀	水 見	氵 見
莧	草 見	艸 見	艹 見
陷	阜 臽	阝 臽
晛	日 見
現	玉 見	王 見
硍	石 艮
馅	食 臽	饣 臽
睍	目 見
絤	絲 西	糹 西	糸 西
缐	丝 泉	纟 泉
羡	羊 次
献	南 犬
粯	米 見
羨	羊 水 欠	羊 氵 欠
腺	肉 泉	月 泉
蜆	蟲 見	虫 見
僩	人 閒	亻 閒
僴	人 間	亻 間
綫	絲 戔	糹 戔	糸 戔
誢	言 見	訁 見
撊	手 閒	扌 閒	才 閒
線	絲 泉	糹 泉	糸 泉
鋧	金 見	釒 見
憲	宀 丰 网 心	宀 丰 罒 心
橌	木 閒
縣	県 系
錎	金 臽	釒 臽
餡	食 臽	飠 臽
壏	土 監
豏	豆 兼
麲	麥 見
瀗	水 憲	氵 憲
臔	肉 賢	月 賢
獻	虎 鬲 犬	虍 鬲 犬
糮	米 堅
霰	雨 散
鼸	鼠 兼
乡	𠃋 𠃋 丿
芗	草 乡	艸 乡	艹 乡
相	木 目
香	禾 日
郷	乡 艮 邑	乡 艮 阝
厢	厂 相
啌	口 空
鄉	乡 郎
鄊	乡 耶 邑	乡 耶 阝
廂	厂 相
湘	水 相	氵 相
缃	丝 相	纟 相
葙	草 相	艸 相	艹 相
鄕	乡 郎 邑	乡 郎 阝
薌	草 鄉	艸 鄉	艹 鄉
箱	竹 相
緗	絲 相	糹 相	糸 相
膷	肉 鄉	月 鄉
襄	亠 口 口 井 一 衣
忀	彳 襄
骧	马 襄
麘	鹿 香
欀	木 襄
瓖	玉 襄	王 襄
镶	金 襄	钅 襄
鑲	金 襄	釒 襄
驤	馬 襄
瓨	工 瓦
佭	人 夅	亻 夅
详	讠 羊	讠 羊
庠	广 羊
栙	木 夅
祥	示 羊	礻 羊
絴	絲 羊	糹 羊	糸 羊
翔	羊 羽
詳	言 羊	訁 羊
跭	足 夅
享	亠 口 子
亯	亠 口 日
响	口 向
响	向 口
蚃	乡 虫
饷	食 向	饣 向
晑	日 向
飨	食 乡
想	相 心
銄	金 向	釒 向
餉	食 向	飠 向
鲞	丷 夫 鱼	𠔉 鱼
曏	日 鄉
蠁	鄉 蟲	鄉 虫
鮝	丷 夫 魚	𠔉 魚
鯗	羊 八 魚
響	鄉 音
饗	鄉 食
饟	食 襄
鱶	魚 養
向	丿 冂 口
向	丶 冂 口
姠	女 向
巷	共 己
项	工 页
珦	玉 向	王 向
象	刀 口 丨 豕	刀 冖 丨 豕
塂	土 巷
缿	缶 后
萫	草 香	艸 香	艹 香
衖	行 共	彳 共 亍
項	工 頁
像	人 象	亻 象
勨	象 力
嶑	山 象
銗	金 后	釒 后
橡	木 象
襐	衣 象	衤 象
嚮	鄉 向
蟓	虫 象
蟓	蟲 象	虫 象
鐌	金 象	釒 象
鱌	魚 象
灱	火 刀
灲	火 刀	火 刂
呺	口 号
枭	鸟 木
侾	人 孝	亻 孝
哓	口 尧
枵	木 号
骁	马 尧
哮	口 孝
宯	宀 孝
宵	宀 肖
庨	广 孝
消	水 肖	氵 肖
绡	丝 肖	纟 肖
虓	九 虎
逍	辵 肖	辶 肖
鸮	号 鸟
婋	女 虎
梟	鳥 木
焇	火 肖
猇	犬 虎	犭 虎
萧	草 肃	艹 肃	艸 肃
痚	病 孝	疒 孝
痟	病 肖	疒 肖
硝	石 肖
硣	石 孝
窙	穴 孝
翛	攸 羽
萷	草 削	艸 削	艹 削
销	金 肖	钅 肖
揱	削 手
綃	絲 肖	糹 肖	糸 肖
嘐	口 翏
歊	高 欠
潇	水 肃	氵 肃
箫	竹 肃
踃	足 肖
嘵	口 堯
憢	心 堯	忄 堯
獢	犬 喬	犭 喬
銷	金 肖	釒 肖
霄	雨 肖
彇	弓 肅
膮	肉 堯	月 堯
蕭	草 肅	艸 肅	艹 肅
魈	鬼 肖
鴞	号 鳥
穘	禾 堯
簘	竹 粛
藃	草 歊	艸 歊	艹 歊
蟂	蟲 梟	虫 梟
蟏	虫 萧
鴵	兆 鳥
嚣	口 口 页 口 口
瀟	水 蕭	氵 蕭
簫	竹 肅
蟰	蟲 肅	虫 肅
髇	骨 高
櫹	木 蕭
嚻	口 口 頁 口 口	吕 頁 吕
囂	口 口 頁 口 口
髐	骨 堯
鷍	臬 鳥
蠨	蟲 蕭	虫 蕭
驍	馬 堯
毊	殸 喬
虈	草 吕 頁 吕	艸 吕 頁 吕	艹 吕 頁 吕	艹 口 口 頁 口 口	艹 囂
洨	水 交	氵 交
郩	肴 邑	肴 阝
崤	山 肴
淆	水 肴	氵 肴
訤	言 爻	訁 爻
殽	肴 殳
筊	竹 交
誵	言 肴	訁 肴
小	八 亅
晓	日 尧
暁	日 尭
筱	竹 攸
筿	竹 条
皛	白 白 白
曉	日 堯
篠	竹 條
謏	言 叟	訁 叟
皢	白 堯
孝	老 子	耂 子
肖	小 肉	小 月
効	交 力
咲	口 关
俲	人 効	亻 効
效	交 攴	交 攵
校	木 交
涍	水 孝	氵 孝
笑	竹 夭
啸	口 肃
傚	人 交 攴	人 交 攵	亻 交 攵
敩	学 攴	学 攵
詨	言 交	訁 交
嘋	口 教
嘨	口 粛
誟	言 孝	訁 孝
嘯	口 肅
歗	肅 欠
熽	火 肅
斅	學 攴
斆	學 攴	學 攵
些	此 二
揳	手 契	扌 契	才 契
猲	犬 葛	犭 葛
楔	木 契
歇	曷 欠
蝎	虫 曷
蝎	蟲 曷	虫 曷
蠍	虫 歇
蠍	蟲 歇	虫 歇
劦	力 力 力
协	十 办
旪	日 十
邪	牙 邑	牙 阝
協	十 劦
胁	肉 办	月 办
垥	土 合
奊	丨 一 圭 大
峫	山 邪
恊	心 劦	忄 劦
拹	手 劦	扌 劦	才 劦
挟	手 夹	扌 夹	才 夹
挾	手 夾	扌 夾	才 夾
脅	劦 肉	劦 月
脇	肉 劦	月 劦
衺	衣 牙
偕	人 皆	亻 皆
斜	余 斗
谐	言 皆	讠 皆
翓	吉 羽
嗋	口 脅
愶	心 脅	忄 脅
携	手 隽	扌 隽
携	手 隽	扌 隽	才 隽
瑎	玉 皆	王 皆
綊	絲 夾	糹 夾	糸 夾
熁	火 脅
膎	肉 奚	月 奚
勰	劦 思
撷	手 颉	扌 颉	才 颉
擕	手 雋	扌 雋	才 雋
緳	广 絜
缬	丝 颉	纟 颉
蝢	蟲 頁	虫 頁
鞋	革 圭
頡	吉 頁
諧	言 皆	訁 皆
燲	火 劦 貝
擷	手 頡	扌 頡	才 頡
鞵	革 奚
襭	衣 頡	衤 頡
攜	手 雟	扌 雟	才 雟
纈	絲 頡	糹 頡	糸 頡
讗	言 巂	訁 巂
龤	龠 皆
写	冖 与
冩	冖 舄
寫	宀 舄
藛	草 寫	艸 寫	艹 寫
伳	人 世	亻 世
灺	火 也
泄	水 世	氵 世
泻	水 写	氵 写
祄	示 介	礻 介
绁	丝 世	纟 世
缷	缶 卩
卸	午 止 卩
洩	水 曳	氵 曳
炧	火 丿 一 也
炨	火 它
卨	卜 咼
娎	折 女
屑	尸 肖
屓	尸 貝
偞	人 枼	亻 枼
偰	人 契	亻 契
徢	彳 疌
械	木 戒
烲	折 火
焎	折 火	折 灬
禼	卜 口 乂 冂 厶
紲	絲 世	糹 世	糸 世
亵	执 衣
媟	女 枼
屟	尸 枼
渫	水 枼	氵 枼
絏	絲 曳	糹 曳	糸 曳
絬	絲 舌	糹 舌	糸 舌
谢	言 射	讠 射
僁	人 悉	亻 悉
塮	土 射
榍	木 屑
榭	木 射
褉	衣 契	衤 契
噧	口 萬
屧	尸 彳 枼
屧	尸 彳 枼	尸 彳 世 木
暬	埶 日
緤	絲 枼	糹 枼	糸 枼
嶰	山 解
廨	广 解
懈	心 解	忄 解
澥	水 解	氵 解
獬	犬 解	犭 解
糏	米 屑
薢	草 解	艸 解	艹 解
薤	草 歹 韭	艸 歹 韭	艹 歹 韭
邂	辵 解	辶 解
韰	歺 又 韭
燮	火 言 火 又
褻	衣 埶	衣 執
謝	言 射	訁 射
瀉	水 寫	氵 寫
鞢	革 枼
瀣	水 韰	氵 韰
爕	火 言 火 火
繲	絲 解	糹 解	糸 解
蟹	解 虫
蟹	解 蟲	解 虫
蠏	虫 解
蠏	蟲 解	虫 解
齘	齒 介
齛	齒 世
齥	齒 曳
齂	鼻 隶
躞	足 燮
心	丿 乚 丶 丶
妡	女 斤
忻	心 斤	忄 斤
芯	草 心	艸 心	艹 心
辛	立 十
昕	日 斤
杺	木 心
欣	斤 欠
炘	火 斤
盺	目 斤
俽	人 欣	亻 欣
惞	心 欣	忄 欣
訢	言 斤	訁 斤
鈊	金 心	釒 心
锌	金 辛	钅 辛
新	亲 斤	立 木 斤
歆	音 欠
廞	广 欽
鋅	金 辛	釒 辛
薪	草 新	艸 新	艹 新
馨	声 殳 香	殸 香
鑫	金 金 金
馫	香 香 香
枔	木 今
襑	衣 尋	衤 尋
鐔	金 覃	釒 覃
伈	人 心	亻 心
阠	阜 卂	阝 卂
伩	人 文	亻 文
囟	丶 囗 乂
孞	子 心
信	人 言	亻 言
軐	車 卂
脪	肉 希	月 希
衅	血 半
訫	言 心	訁 心
焮	火 欣
馸	馬 斤
顖	囟 心 頁
舋	臼 同 冖 且
釁	臼 同 冖 酉 分
星	生 日
垶	土 辛
骍	马 辛
惺	心 星	忄 星
猩	犬 星	犭 星
煋	火 星
瑆	玉 星	王 星
腥	肉 星	月 星
蛵	蟲 巠	虫 巠
觪	角 辛
箵	竹 省
篂	竹 星
鮏	魚 生
曐	晶 生
觲	角 羊 牛
騂	馬 辛
皨	皛 土
鯹	魚 星
刑	开 刀	开 刂
行	彳 亍
邢	开 邑	开 阝
形	开 彡
陉	阜 𢀖	阝 𢀖
侀	人 刑	亻 刑
郉	幵 邑	幵 阝
型	刑 土
洐	水 行	氵 行
荥	草 冖 水	艸 冖 水	艹 冖 水
钘	金 开	钅 开
陘	阜 巠	阝 巠
娙	女 巠
硎	石 刑
铏	金 刑	钅 刑
鈃	金 开	釒 开
滎	火 火 冖 水	𤇾 水
鉶	金 刑	釒 刑
銒	金 幵	釒 幵
鋞	金 巠	釒 巠
睲	目 星
醒	酉 星
擤	手 鼻	扌 鼻	才 鼻
兴	丷 六
杏	木 口
姓	女 生
幸	土 丷 二 丨	土 羊
幸	土 丷 干	土 羊
性	心 生	忄 生
荇	草 行	艸 行	艹 行
倖	人 幸	亻 幸
莕	草 杏	艸 杏	艹 杏
婞	女 幸
悻	心 幸	忄 幸
涬	水 幸	氵 幸
緈	絲 幸	糹 幸	糸 幸
興	臼 同 大
嬹	女 興
臖	興 肉	興 月
凶	凵 乂
兄	口 儿
兇	凶 儿
匈	勹 凶
讻	言 凶	讠 凶
忷	心 凶	忄 凶
汹	水 凶	氵 凶
哅	口 匈
恟	心 匈	忄 匈
洶	水 匈	氵 匈
胷	匈 肉	匈 月
胸	肉 匈	月 匈
訩	言 凶	訁 凶
詾	言 匈	訁 匈
賯	貝 旬 子
雄	厷 隹
熊	能 火	能 灬
诇	言 冋	讠 冋
焸	日 日 火
詗	言 冋	訁 冋
夐	刀 罓 目 夂
敻	刀 内 目 夕	刀 内 目 夂
休	人 木	亻 木
俢	人 夕 彡	亻 夂 彡
修	攸 彡
咻	口 休
庥	广 休
烋	休 火	休 灬
烌	火 休
羞	羊 丑
羞	羊 丿 丑
脩	攸 肉	攸 月
脙	肉 求	月 求
鸺	休 鸟
臹	至 成
貅	豸 休
馐	饣 羞
樇	木 脩
銝	金 休	釒 休
髤	髟 木
髹	髟 休
鎀	金 修	釒 修
鵂	休 鳥
鏅	金 脩	釒 脩
饈	食 羞
鱃	魚 羞
苬	草 囚	艸 囚	艹 囚
朽	木 丂
滫	水 脩	氵 脩
潃	水 彳 攵 肉	氵 彳 攵 肉	水 彳 攵 月	氵 彳 攵 月
綇	絲 酉	糹 酉	糸 酉
糔	米 蚤
秀	禾 乃
岫	山 由
峀	山 田
珛	玉 有	王 有
绣	丝 秀	纟 秀
袖	衣 由	衤 由
琇	玉 秀	王 秀
锈	金 秀	钅 秀
嗅	口 臭
溴	水 臭	氵 臭
褎	衣 厂 二 禾
褏	衣 厂 二 由
銹	金 秀	釒 秀
螑	虫 臭
螑	蟲 臭	虫 臭
繍	絲 粛	糹 粛	糸 粛
繡	絲 肅	糹 肅	糸 肅
鏥	金 宿	釒 宿
鏽	金 肅	釒 肅
齅	鼻 臭
吁	口 于
戌	戊 一
旴	日 于
疞	病 亏	疒 亏
盱	目 于
欨	句 欠
胥	疋 月
须	彡 页
晇	日 夸
訏	言 于	訁 于
顼	玉 页	王 页
虗	虎 丘	虍 丘
虚	虎 业	虍 业
谞	言 胥	讠 胥
媭	须 女
幁	巾 頁
揟	手 胥	扌 胥	才 胥
湑	水 胥	氵 胥
虛	虎 丱 一	虍 丱 一
須	彡 頁
楈	木 疋 月
窢	穴 或
頊	玉 頁	王 頁
嘘	口 虚
墟	土 虚
墟	土 虛
需	雨 而
魆	鬼 戉
噓	口 虛
嬃	須 女
歔	虚 欠
歔	虛 欠
縃	絲 胥	糹 胥	糸 胥
蕦	草 須	艸 須	艹 須
蝑	虫 胥
蝑	蟲 胥	虫 胥
諝	言 胥	訁 胥
譃	言 虛	訁 虛
繻	絲 需	糹 需	糸 需
魖	鬼 虛
驉	馬 虛
鑐	金 需	釒 需
鬚	髟 须
俆	人 余	亻 余
徐	彳 余
蒣	草 徐	艸 徐	艹 徐
许	言 午	讠 午
呴	口 句
姁	女 句
诩	言 羽	讠 羽
冔	冃 吁	冂 二 吁
栩	木 羽
珝	玉 羽	王 羽
偦	人 女 疋	亻 女 疋
許	言 午	訁 午
暊	日 頁
詡	言 羽	訁 羽
稰	禾 胥
鄦	無 邑	無 阝
糈	米 胥
醑	酉 胥
盨	須 皿
旭	九 日
伵	人 四	亻 四
序	广 予
汿	水 予	氵 予
芧	草 予	艸 予	艹 予
侐	人 血	亻 血
卹	血 卩
怴	心 戉	忄 戉
沀	水 予
叙	余 又
恤	心 血	忄 血
昫	日 句
洫	水 血	氵 血
垿	土 序
欰	血 欠
殈	歹 血
烅	火 血
珬	玉 戌	王 戌
勖	冒 力
敍	余 攴
敘	余 攴	余 攵
勗	日 助
烼	火 豕
绪	丝 者	纟 者
续	丝 卖	纟 卖
酗	酉 凶
喣	呴 火	呴 灬
壻	土 胥
婿	女 胥
朂	曰 耳 力	日 耳 力
溆	水 叙	氵 叙
絮	如 丝	如 糸
絮	如 絲	如 糸
訹	言 朮	訁 朮
慉	心 畜	忄 畜
煦	昫 火	昫 灬
蓄	草 畜	艸 畜	艹 畜
賉	貝 血
槒	木 畜
漵	水 敘	氵 敘
潊	水 敍	氵 敍
盢	畎 皿
瞁	目 狊
緒	絲 者	糹 者	糸 者
聟	知 耳
銊	金 戌	釒 戌
獝	犬 矞	犭 矞
稸	禾 畜
緖	絲 者 丶	糹 者 丶	糸 者 丶
魣	魚 予
藇	草 與	艸 與	艹 與
瞲	目 矞
藚	草 賣	艸 賣	艹 賣
續	絲 賣	糹 賣	糸 賣
鱮	魚 與
蓿	草 宿	艸 宿	艹 宿
吅	口 口
轩	车 干
昍	日 日
宣	宀 亘
弲	弓 肙
軒	車 干
梋	木 肙
谖	言 爰	讠 爰
喧	口 宣
塇	土 宣
媗	女 宣
愃	心 宣	忄 宣
愋	心 爰	忄 爰
揎	手 宣	扌 宣	才 宣
萱	草 宣	艸 宣	艹 宣
萲	草 爰	艸 爰	艹 爰
暄	日 宣
煊	火 宣
瑄	玉 宣	王 宣
蓒	草 軒	艸 軒	艹 軒
睻	目 宣
儇	人 睘	亻 睘
禤	示 目 羽	礻 罒 羽
翧	宣 羽
蝖	虫 宣
蝖	蟲 宣	虫 宣
鋗	金 肙	釒 肙
懁	心 睘	忄 睘
蕿	草 煖	艸 煖	艹 煖
諠	言 宣	訁 宣
諼	言 爰	訁 爰
鍹	金 宣	釒 宣
駽	馬 肙
矎	目 夐
翾	睘 羽
藼	草 憲	艸 憲	艹 憲
蘐	草 諼	艸 諼	艹 諼
蠉	虫 睘
蠉	蟲 睘	虫 睘
譞	言 睘	訁 睘
玄	亠 幺
玹	玉 玄	王 玄
痃	病 玄	疒 玄
悬	县 心
旋	方 丿 一 疋
琁	玉 丿 一 疋	王 丿 一 疋
蜁	虫 丿 一 疋
蜁	蟲 丿 一 疋	虫 丿 一 疋
嫙	女 旋
漩	水 旋	氵 旋
暶	日 旋
璇	玉 旋	王 旋
檈	木 睘
璿	玉 睿	王 睿
懸	縣 心
咺	口 亘
选	辵 先	辶 先
晅	日 亘
烜	火 亘
選	辵 巽	辶 巽
顈	匕 糸 頁
癣	病 鲜	疒 鲜
癬	病 鮮	疒 鮮
怰	心 玄	忄 玄
泫	水 玄	氵 玄
昡	日 玄
炫	火 玄
绚	丝 旬	纟 旬
眩	目 玄
袨	衣 玄	衤 玄
铉	金 玄	钅 玄
琄	玉 肙	王 肙
眴	目 旬
衒	行 玄	彳 玄 亍
渲	水 宣	氵 宣
絢	絲 旬	糹 旬	糸 旬
楥	木 爰
楦	木 宣
鉉	金 玄	釒 玄
碹	石 宣
蔙	草 旋	艸 旋	艹 旋
镟	金 旋	钅 旋
鞙	革 肙
颴	風 丿 一 疋
縼	絲 旋	糹 旋	糸 旋
繏	絲 巽	糹 巽	糸 巽
鏇	金 旋	釒 旋
讂	言 夐	訁 夐
贙	虎 虎 貝
削	肖 刀	肖 刂
疶	病 世	疒 世
蒆	草 巩 女	艸 巩 女	艹 巩 女
靴	革 化
薛	草 戶 乛 一 辛	艸 戶 乛 一 辛	艹 戶 乛 一 辛
薛	草 户 乛 一 辛	艸 户 乛 一 辛	艹 户 乛 一 辛
辥	屮 戶 乛 一 辛	屮 户 乛 一 辛
鞾	革 華
穴	宀 八
斈	文 子
乴	折 乙
学	小 冖 子
岤	山 穴
峃	小 冖 山
茓	草 穴	艸 穴	艹 穴
泶	小 冖 水
袕	衣 穴	衤 穴
鸴	小 冖 鸟
踅	折 足
壆	臼 爻 冖 土
壆	臼 爻 冖 土	𦥯 土
學	臼 爻 冖 子	𦥯 子
嶨	臼 爻 冖 山	𦥯 山
澩	臼 爻 冖 水	𦥯 水
燢	臼 爻 冖 火	𦥯 火
觷	臼 爻 冖 角	𦥯 角
雤	臼 爻 冖 隹	𦥯 隹
鷽	臼 爻 冖 鳥	𦥯 鳥
雪	雨 彐
鳕	鱼 雪
鱈	魚 雪
血	丶 皿	丿 皿
吷	口 夬
坹	土 穴
狘	犬 戉	犭 戉
桖	木 血
谑	言 虐	讠 虐
趐	走 羽
謔	言 虐	訁 虐
瀥	水 翯	氵 翯
坃	土 元
勋	员 力
埙	土 员
焄	君 火	君 灬
勛	員 力
塤	土 員
熏	丿 一 黑	丿 一 里 丷 火	丿 一 里 丷 灬
窨	穴 音
蔒	草 焄	艸 焄	艹 焄
勲	動 火	動 灬
勳	熏 力
薫	草 熏	艸 熏	艹 熏
薫	草 重 火	艸 重 灬	艹 重 灬
駨	馬 旬
壎	土 熏
獯	犬 熏	犭 熏
薰	草 熏	艸 熏	艹 熏
曛	日 熏
燻	火 熏
臐	肉 熏	月 熏
矄	目 熏
蘍	草 勳	艸 勳	艹 勳
壦	土 雚
爋	火 勳
纁	絲 熏	糹 熏	糸 熏
醺	酉 熏
廵	廴 巛
寻	彐 寸
旬	勹 日
巡	辵 巛	辶 巛
驯	马 川
杊	木 川
畃	申 勺
询	言 旬	讠 旬
峋	山 旬
恂	心 旬	忄 旬
洵	水 旬	氵 旬
浔	水 寻	氵 寻
紃	絲 川	糹 川	糸 川
荀	草 旬	艸 旬	艹 旬
荨	草 寻	艸 寻	艹 寻
栒	木 旬
桪	木 寻
毥	毛 旬
珣	玉 旬	王 旬
偱	人 盾	亻 盾
尋	彐 工 口 寸
循	彳 盾
揗	手 盾	扌 盾	才 盾
詢	言 旬	訁 旬
馴	馬 川
鄩	尋 邑	尋 阝
鲟	鱼 寻
噚	口 尋
潯	水 尋	氵 尋
攳	支 尋
樳	木 尋
燅	埶 炎
燖	火 尋
璕	玉 尋	王 尋
蟳	蟲 尋	虫 尋
鱏	魚 覃
鱘	魚 尋
灥	泉 泉 泉
卂	乙 十
训	言 川	讠 川
讯	言 卂	讠 卂
伨	人 勻	亻 勻
伨	人 匀
汛	水 卂	氵 卂
迅	辵 卂	辶 卂
侚	人 旬	亻 旬
巺	巳 巳 一 八
徇	彳 旬
狥	犬 旬	犭 旬
迿	辵 旬	辶 旬
逊	辵 孙	辶 孙
殉	歹 旬
訊	言 卂	訁 卂
訓	言 川	訁 川
訙	言 丸	訁 丸
奞	大 隹
巽	己 己 共
殾	者 殳
稄	禾 夋
遜	辵 孫	辶 孫
愻	孫 心
賐	貝 夋
噀	口 巽
潠	水 巽	氵 巽
蕈	草 覃	艸 覃	艹 覃
顨	頁 頁 丌
鑂	金 熏	釒 熏
丫	丶 丶 丨
圧	厂 土
压	厂 圡
压	厂 圡	厂 土 丶
吖	口 丫
庘	广 甲
押	手 甲	扌 甲	才 甲
枒	木 牙
垭	土 亚
鸦	牙 鸟
桠	木 亚
鸭	甲 鸟
埡	土 亞
孲	子 亞
铔	金 亚	钅 亚
椏	木 亞
鴉	牙 鳥
錏	金 亞	釒 亞
鴨	甲 鳥
壓	厭 土
鵶	亞 鳥
鐚	金 惡	釒 惡
牙	丅 一 亅 丿
伢	人 牙	亻 牙
岈	山 牙
芽	草 牙	艸 牙	艹 牙
厓	厂 圭
玡	玉 牙	王 牙
琊	玉 邪	王 邪
笌	竹 牙
蚜	虫 牙
蚜	蟲 牙	虫 牙
堐	土 厓
崕	山 厓
崖	山 厓
涯	水 厓	氵 厓
猚	犬 隹	犭 隹
瑘	玉 耶	王 耶
睚	目 厓
衙	行 吾	彳 吾 亍
漄	水 崖	氵 崖
齖	齒 牙
厊	厂 牙
庌	广 牙
哑	口 亚
唖	口 亜
啞	口 亞
痖	病 亚	疒 亚
雅	牙 隹
瘂	病 亞	疒 亞
蕥	草 雅	艸 雅	艹 雅
劜	力 乚
圠	土 乚
轧	车 乚
亚	一 业
襾	一 凵 冂
讶	言 牙	讠 牙
亜	二 口 丨 丨
犽	犬 牙	犭 牙
迓	辵 牙	辶 牙
亞	二 十
軋	車 乚
娅	女 亚
挜	手 亚	扌 亚	才 亚
砑	石 牙
俹	人 亞	亻 亞
氩	气 亚
婭	女 亞
掗	手 亞	扌 亞	才 亞
訝	言 牙	訁 牙
揠	手 匽	扌 匽	才 匽
氬	氣 亞	气 亞
猰	犬 契	犭 契
聐	耳 吉
圔	囗 盍
稏	禾 亞
窫	穴 契
齾	獻 齒
呀	口 牙
恹	心 厌	忄 厌
剦	奄 刀	奄 刂
烟	火 因
珚	玉 因	王 因
胭	肉 因	月 因
偣	人 音	亻 音
崦	山 奄
淊	水 臽	氵 臽
淹	水 奄	氵 奄
焉	正 一 勹 火	正 一 勹 灬
菸	草 於	艸 於	艹 於
阉	门 奄
湮	水 垔	氵 垔
腌	肉 奄	月 奄
煙	火 垔
硽	石 奄
鄢	焉 邑	焉 阝
嫣	女 焉
漹	水 焉	氵 焉
嶖	山 翕
醃	酉 奄
閹	門 奄
嬮	厭 女
懨	心 厭	忄 厭
篶	竹 焉
懕	厭 心
臙	肉 燕	月 燕
黫	黑 垔
讠	丶 一 二 口 訁
延	廴 丿 止
闫	门 三
严	亚 丿
妍	女 开
芫	草 元	艸 元	艹 元
言	二 二 口	丶 一 二 口
訁	丶 一 二 口
岩	山 石
昖	日 公
沿	水 八 口	氵 八 口
炎	火 火
郔	延 邑	延 阝
姸	女 幵
娫	女 延
狿	犬 延	犭 延
研	石 开
莚	草 延	艸 延	艹 延
娮	女 言
盐	土 卜 皿
啱	口 岩
琂	玉 言	王 言
硏	石 幵
訮	言 开	訁 开
閆	門 三
阎	门 臽
嵒	品 山
嵓	山 品
筵	竹 延
綖	絲 延	糹 延	糸 延
蜒	虫 延
蜒	蟲 延	虫 延
塩	土 土 丿 一 口 皿
揅	研 手
楌	木 彦
詽	言 幵	訁 幵
碞	品 石
蔅	草 門 女	艸 門 女	艹 門 女
颜	彦 页
厳	小 厂 敢
虤	虎 虎
閻	門 臽
檐	木 詹
顏	彦 頁
顔	彥 頁
嚴	口 口 厂 敢
壛	土 閻
巌	山 厳
簷	竹 詹
櫩	木 閻
黬	黑 咸
壧	土 嚴
孍	女 嚴
巗	山 嚴
巖	山 嚴
礹	石 嚴
鹽	臣 丿 一 鹵 皿
麣	鹿 嚴
夵	大 小
抁	手 允	扌 允	才 允
沇	水 允	氵 允
乵	辛 乙	辛 乚
兖	亠 兊
奄	大 电
俨	人 严	亻 严
兗	亠 兌
匽	匚 妟
弇	合 廾
衍	行 水	行 氵	彳 氵 亍
偃	人 匽	亻 匽	人 匚 妟	亻 匚 妟	人 匚 日 女	亻 匚 日 女
厣	厌 甲	厂 犬 甲
掩	手 奄	扌 奄	才 奄
眼	目 艮
萒	草 兖	艸 兖	艹 兖
郾	匽 邑	匽 阝
酓	今 酉
嵃	山 彦
愝	心 匽	忄 匽
扊	戶 炎
扊	户 炎
揜	手 弇	扌 弇	才 弇
棪	木 炎
渰	水 弇	氵 弇
渷	水 兗	氵 兗
琰	玉 炎	王 炎
遃	辵 彦	辶 彦
隒	阜 兼	阝 兼
椼	木 衍
罨	网 奄	罒 奄
裺	衣 奄	衤 奄
演	水 寅	氵 寅
褗	衣 匽	衤 匽
戭	寅 戈
蝘	虫 匽
蝘	蟲 匽	虫 匽
魇	厌 鬼
噞	口 僉
躽	身 匽
縯	絲 寅	糹 寅	糸 寅
檿	壓 木
黡	厌 黑
厴	厭 甲	厂 猒 甲
甗	虎 鬲 瓦	虍 鬲 瓦
鰋	魚 匽
鶠	匽 鳥
黤	黑 奄
齞	齒 只
龑	龍 天
儼	人 嚴	亻 嚴
黭	黑 弇
顩	僉 頁
鼴	鼠 匽
巘	山 獻
巚	山 獻
曮	日 嚴
魘	厭 鬼
鼹	鼠 妟
齴	齒 彦
黶	壓 黑
厌	厂 犬
妟	日 女
觃	见 子
牪	牛 牛
咽	口 因
姲	女 安
彥	文 厂 彡
彦	亠 丷 厂 彡
砚	石 见
唁	口 言
宴	宀 妟
晏	日 安
烻	火 延
艳	丰 色
覎	見 子
验	马 佥
偐	人 彦	亻 彦
焔	火 刀 旧
谚	言 彦	讠 彦
隁	阜 匽	阝 匽
喭	口 彦
堰	土 匽
敥	炎 攴
焰	火 臽
焱	火 火 火
猒	冐 犬	日 肉 犬	日 月 犬
硯	石 見
葕	草 衍	艸 衍	艹 衍
雁	厂 人 隹	厂 亻 隹	厂 倠
傿	人 焉	亻 焉
椻	木 匽
溎	水 桂	氵 桂
滟	水 艳	氵 艳
鳫	厂 鳥
厭	厂 猒
墕	土 焉
暥	日 妟
酽	酉 严
嬊	廿 北 口 女
谳	言 献	讠 献
餍	厌 食
鴈	厂 人 鳥	厂 亻 鳥
燄	臽 炎
燕	廿 北 口 火	廿 北 口 灬
諺	言 彦	訁 彦
赝	厂 人 隹 贝	厂 亻 隹 贝	厂 倠 贝
鬳	虎 鬲	虍 鬲
曕	日 詹
鴳	安 鳥
酀	燕 邑	燕 阝
騐	馬 念
験	馬 人 一 口 人
嚥	口 燕
嬿	女 燕
艶	豊 色
贋	厂 人 隹 貝	厂 亻 隹 貝	厂 倠 貝
曣	日 燕
爓	火 閻
醶	酉 僉
騴	馬 妟
鷃	妟 鳥
灔	水 艶	氵 艶
贗	厂 人 鳥 貝	厂 亻 鳥 貝
觾	角 燕
讌	言 燕	訁 燕
醼	酉 燕
饜	厭 食
驗	馬 僉
鷰	廿 北 口 鳥
艷	豐 色
灎	水 豊 盍	氵 豊 盍
釅	酉 嚴
驠	馬 燕
灧	水 艷	氵 艷
讞	言 獻	訁 獻
豓	豐 盇
豔	豐 盍
灩	水 豔	氵 豔
灩	水 豔	氵 豔	氵 豐 盍
央	冂 大
咉	口 央
姎	女 央
抰	手 央	扌 央	才 央
泱	水 央	氵 央
殃	歹 央
胦	肉 央	月 央
眏	目 央
秧	禾 央
鸯	央 鸟
鉠	金 央	釒 央
雵	雨 央
鞅	革 央
鴦	央 鳥
扬	手 弓 丿 丿	扌 弓 丿 丿	才 弓 丿 丿
羊	丷 三 丨
阦	阜 火	阝 火
阳	阜 日	阝 日
旸	日 弓 丿 丿
杨	木 弓 丿 丿
炀	火 弓 丿 丿
飏	风 弓 丿 丿
佯	人 羊	亻 羊
劷	羊 力
氜	气 日
氜	氣 日	气 日
疡	病 弓 丿 丿	疒 弓 丿 丿
钖	金 弓 丿 丿	钅 弓 丿 丿
垟	土 羊
徉	彳 羊
昜	日 一 勿
洋	水 羊	氵 羊
羏	羊 彡
烊	火 羊
珜	玉 羊	王 羊
眻	目 羊
陽	阜 昜	阝 昜
崵	山 昜
崸	山 頁
揚	手 昜	扌 昜	才 昜
蛘	虫 羊
蛘	蟲 羊	虫 羊
敭	易 攴	易 攵
暘	日 昜
楊	木 昜	木 日 一 勿
煬	火 昜
禓	示 昜	礻 昜
瘍	病 昜	疒 昜
諹	言 昜	訁 昜
輰	車 昜
鍚	金 昜	釒 昜
鴹	羊 鳥
颺	風 昜
鐊	金 陽	釒 陽
鰑	魚 昜
霷	雨 晹
鸉	楊 鳥
仰	人 卬	亻 卬
佒	人 央	亻 央
坱	土 央
岟	山 央
养	羊 介	羊 乀 丿 丨 丨
柍	木 央
炴	火 央
氧	气 羊
氧	氣 羊	气 羊
痒	病 羊	疒 羊
紻	絲 央	糹 央	糸 央
傟	人 翁	亻 翁
楧	木 英
軮	車 央
慃	心 翁	忄 翁
氱	氣 昜	气 昜
蝆	虫 芈
蝆	蟲 芈	虫 芈
養	羊 食
駚	馬 央
懩	心 養	忄 養
攁	手 養	扌 養	才 養
癢	病 養	疒 養
怏	心 央	忄 央
恙	羊 心
样	木 羊
羕	羊 永
詇	言 央	訁 央
様	木 羊 水
漾	水 羕	氵 羕
樣	木 羕
瀁	水 養	氵 養
幺	𠃊 厶
夭	丿 大
吆	口 幺
妖	女 夭
枖	木 夭
殀	歹 夭
祅	示 夭	礻 夭
訞	言 夭	訁 夭
喓	口 要
葽	草 要	艸 要	艹 要
楆	木 要
腰	肉 要	月 要
鴁	夭 鳥
邀	辵 敫	辶 敫
爻	乂 乂
尧	一 𠄌 丿 兀
尭	卉 兀
肴	乂 有	乂 一 丿 肉	乂 一 丿 月
垚	土 土 土
姚	女 兆
峣	山 尧
轺	车 召
倄	人 肴	亻 肴
烑	火 兆
珧	玉 兆	王 兆
窑	穴 缶
傜	人 月 缶	亻 月 缶	人 䍃	亻 䍃
傜	人 爪 缶	亻 爫 缶
堯	垚 兀
揺	手 爪 击	扌 爫 击	才 爫 击
谣	言 爪 缶	讠 爫 缶
軺	車 召
嗂	口 月 缶	口 䍃
媱	女 月 缶	女 䍃
徭	彳 月 缶	彳 䍃
愮	心 月 缶	忄 月 缶	心 䍃	忄 䍃
搖	手 月 缶	扌 月 缶	才 月 缶	手 䍃	扌 䍃	才 䍃
摇	手 爪 缶	扌 爫 缶	才 爫 缶
滧	水 效
猺	犬 月 缶	犭 月 缶	犬 䍃	犭 䍃
遙	辵 月 缶	辶 月 缶	辵 䍃	辶 䍃
遥	辵 爪 缶	辶 爫 缶
摿	手 人 音	扌 人 音	才 人 音
暚	日 爪 缶	日 爫 缶
榣	木 月 缶	木 䍃
瑤	玉 䍃	王 月 缶	玉 䍃	王 䍃
瑶	玉 爪 缶	王 爫 缶
銚	金 兆	釒 兆
飖	爪 缶 风	爫 缶 风
餆	食 兆
嶢	山 堯
嶤	山 堯
磘	石 爪 缶	石 爫 缶
窯	穴 羔
窰	穴 月 缶	穴 䍃
餚	食 肴	飠 肴
繇	月 缶 系
繇	月 缶 系	䍃 系
謠	言 月 缶	訁 月 缶	言 䍃	訁 䍃
謡	言 爪 击	訁 爫 击
鎐	金 爪 缶	釒 爫 缶
鳐	鱼 爪 缶	鱼 爫 缶
颻	月 缶 風	䍃 風
蘨	草 爪 缶 系	艸 爫 缶 系	艹 爫 缶 系
邎	辵 夕 言 系	辶 夕 言 系
顤	堯 頁
鰩	魚 月 缶	魚 䍃
仸	人 夭	亻 夭
宎	宀 夭
岆	山 夭
抭	手 宀 儿	扌 宀 儿	才 宀 儿
杳	木 日
狕	犬 幼	犭 幼
苭	草 幼	艸 幼	艹 幼
咬	口 交
柼	木 穴
眑	目 幼
窅	穴 目
窈	穴 幼
舀	爪 臼	爫 臼
偠	人 要	亻 要
婹	女 要
崾	山 要
溔	水 羔	氵 羔
蓔	草 羔	艸 羔	艹 羔
榚	木 羔
鴢	幼 鳥
闄	門 要
騕	馬 要
齩	齒 交
鷕	唯 鳥
穾	穴 夭
药	草 约	艸 约	艹 约
要	西 女	襾 女	覀 女
钥	金 月	钅 月
袎	衣 幼	衤 幼
窔	穴 交
筄	竹 兆
葯	草 約	艸 約	艹 約
詏	言 幼	訁 幼
熎	爪 缶	爫 缶
覞	見 見
靿	革 幼
獟	犬 堯	犭 堯
鹞	爪 缶 鸟	爫 缶 鸟
薬	草 楽	艸 楽	艹 楽
鼼	鼻 丩
丩	𠄌 丨	乛 丨
曜	日 翟
燿	火 翟
艞	舟 筄
藥	草 樂	艸 樂	艹 樂
矅	目 翟
耀	光 翟
纅	絲 樂	糹 樂	糸 樂
鷂	爪 缶 鳥	爫 缶 鳥
讑	言 龠	訁 龠
鑰	金 龠	釒 龠
倻	人 耶	亻 耶
掖	手 夜	扌 夜	才 夜
椰	木 耶
暍	日 曷
噎	口 壹
蠮	虫 翳
蠮	蟲 翳	虫 翳
爷	父 卩
耶	耳 邑	耳 阝
捓	手 邪	扌 邪	才 邪
揶	手 耶	扌 耶	才 耶
铘	金 邪	钅 邪
爺	父 耶
釾	金 牙	釒 牙
鋣	金 邪	釒 邪
鎁	金 耶	釒 耶
擨	手 歋	扌 歋	才 歋
也	卩 丨 乚
吔	口 也
冶	冰 台	冫 台
埜	林 土
野	里 予
嘢	口 野
漜	水 埜	氵 埜
壄	楙 土
壄	楙 土	木 矛 木 土
业	丨 丨 丷 一
叶	口 十
曳	曰 𠄌 丿
页	一 丶 贝
曵	曰 乀 丿 丶	日 乀 丿 丶
邺	业 邑	业 阝
夜	亠 人 夕 丶	亠 亻 夕 丶
抴	手 世	扌 世	才 世
亱	亠 但
枼	世 木
洂	水 亦	氵 亦
頁	一 丶 貝
捙	手 車	扌 車	才 車
晔	日 华
枽	卋 木
烨	火 华
啘	口 宛
液	水 夜	氵 夜
谒	言 曷	讠 曷
堨	土 曷
殗	歹 奄
腋	肉 夜	月 夜
葉	草 枼	艸 枼	艹 枼	草 世 木
鄓	臭 邑	臭 阝
墷	土 華
楪	木 枼
業	业 丷 二 木
馌	饣 盍
僷	人 葉	亻 葉
曄	日 華
曅	日 華
歋	虒 欠
燁	火 華
擛	手 葉	扌 葉	才 葉
皣	白 華
瞱	目 華
鄴	業 邑	業 阝
靥	厌 面
嶪	山 業
嶫	山 業
澲	水 業	氵 業
謁	言 曷	訁 曷
餣	食 奄
嚈	口 厭
擫	手 厭	扌 厭	才 厭
曗	日 業
瞸	目 葉
鍱	金 枼	釒 枼
擪	厭 手
爗	火 曅
礏	石 業
鎑	金 盍	釒 盍
饁	食 盍
鵺	夜 鳥
鐷	金 葉	釒 葉
靨	厭 面
驜	馬 業
鸈	業 鳥
一	一
弌	弋 一
衤	丶 乙 丨 丶 丶
伊	人 尹	亻 尹
衣	丶 一 衣
衣	丶 一 衣
医	匚 矢
吚	口 尹
壱	士 冖 匕
依	人 衣	亻 衣
祎	示 韦	礻 韦
咿	口 伊
洢	水 伊	氵 伊
悘	医 心
猗	犬 奇	犭 奇
郼	韋 邑	韋 阝
铱	金 衣	钅 衣
壹	士 冖 豆
揖	手 咠	扌 咠	才 咠	手 口 耳
欹	奇 欠
蛜	虫 伊
蛜	蟲 伊	虫 伊
禕	示 韋	礻 韋
嫛	殹 女
嫛	殹 女	医 几 又 女
漪	水 犬 奇	氵 犭 奇
稦	禾 韋
銥	金 衣	釒 衣
噫	口 意
夁	士 目 固	士 罒 固
瑿	殹 玉
鹥	殹 鸟
繄	殹 糸
檹	木 旖
毉	殹 巫
醫	殹 酉
黟	黑 多
譩	言 意	訁 意
鷖	殹 鳥
黳	殹 黑
仪	人 义	亻 义
匜	匚 也
圯	土 已	土 巳
夷	大 弓	一 弓 人
迆	辵 也	辶 也
冝	冖 且
宐	宀 彑
沂	水 斤	氵 斤
诒	言 台	讠 台
侇	人 夷	亻 夷
宜	宀 且
怡	心 台	忄 台
沶	水 示	氵 示
狋	犬 示	犭 示
衪	衣 也	衤 也
迤	辵 丿 一 也	辶 丿 一 也
饴	食 台	饣 台
咦	口 夷
姨	女 夷
峓	山 夷
恞	心 夷	忄 夷
拸	手 多	扌 多	才 多
柂	木 丿 一 也
珆	玉 台	王 台
瓵	台 瓦
贻	贝 台
迻	辵 多	辶 多
宧	宀 𦣞	宀 匚 丨 口 丨
扅	戶 多
扅	户 多
栘	木 多
桋	木 夷
眙	目 台
胰	肉 夷	月 夷
袘	衣 丿 一 也	衤 丿 一 也
訑	言 也	訁 也
貤	貝 也
痍	病 夷	疒 夷
移	禾 多
耛	耒 台
萓	草 宜	艸 宜	艹 宜
羠	羊 夷
蛦	虫 夷
蛦	蟲 夷	虫 夷
詑	言 它	訁 它
詒	言 台	訁 台
貽	貝 台
遗	辵 贵	辶 贵
媐	巸 女
暆	日 施
椸	木 施
誃	言 多	訁 多
跠	足 夷
頉	止 頁
颐	匚 丨 口 丨 页
飴	食 台	飠 台
疑	匕 矢 龴 疋
儀	人 義	亻 義
熪	火 移
箷	竹 施
遺	辵 貴	辶 貴
嶬	山 義
彛	彐 米 分 廾
彜	彑 米 分 廾
螔	虫 虒
螔	蟲 虒	虫 虒
頤	匚 丨 口 丨 頁
頥	丨 頣
寲	宀 疑
嶷	山 疑
簃	竹 移
顊	阜 頁
彝	彑 米 糸 廾
彞	彐 米 糸 廾
謻	言 移	訁 移
鏔	金 寅	釒 寅
觺	疑 角
讉	言 遺	訁 遺
鸃	鳥 義
乙	乙	乛
已	乛 一 乚
以	𠄌 丶 人
钇	金 乙	钅 乙
佁	人 台	亻 台
攺	已 攴	已 攵	巳 攴	巳 攵
矣	厶 矢
苡	草 以	艸 以	艹 以
苢	草 尸 乛 一	艸 尸 乛 一	艹 尸 乛 一
庡	广 衣
舣	舟 义
蚁	虫 义
釔	金 乙	釒 乙
倚	人 奇	亻 奇
扆	戶 衣
扆	户 衣
笖	竹 以
逘	辵 矣	辶 矣
酏	酉 也
偯	人 哀	亻 哀
崺	山 施
旑	方 奇
椅	木 奇
鈘	金 支	釒 支
鉯	金 以	釒 以
鳦	鳥 乙
裿	衣 奇	衤 奇
旖	方 丿 一 奇
踦	足 奇
輢	車 奇
敼	喜 攴
螘	蟲 豈	虫 豈
檥	木 義
礒	石 義
艤	舟 義
蟻	虫 義	蟲 義
顗	豈 頁
轙	車 義
齮	齒 奇
乂	乀 丿
义	丶 乂
亿	人 乙	亻 乙
弋	一 𠄌 丶
刈	乂 刀	乂 刂
忆	心 乙	忄 乙
艺	草 乙	艸 乙	艹 乙
肊	肉 乙	月 乙
议	言 义	讠 义
亦	亠 丿 亅 八
伇	人 殳	亻 殳
屹	山 乞
异	已 廾	己 廾
芅	草 弋	艸 弋	艹 弋
伿	人 只	亻 只
佚	人 失	亻 失
劮	失 力
呓	口 艺
坄	土 殳
役	彳 殳
抑	手 卬	扌 卬	才 卬
杙	木 弋
耴	耳 乚
苅	草 刈	艸 刈	艹 刈
译	言 又 二 丨	讠 又 二 丨
邑	口 巴
佾	人 八 月	亻 八 月	人 八 肉	亻 八 肉
呭	口 世
呹	口 失
峄	山 又 二 丨
怈	心 世	忄 世
怿	心 又 二 丨	忄 又 二 丨
易	日 勿
枍	木 兮
欥	日 欠
泆	水 失	氵 失
炈	火 殳
秇	禾 丸
绎	丝 又 二 丨	纟 又 二 丨
诣	言 旨	讠 旨
驿	马 又 二 丨
俋	人 邑	亻 邑
奕	亦 大
帟	亦 巾
帠	臼 巾
弈	亦 廾
枻	木 世
浂	水 关	氵 关
玴	玉 世	王 世
疫	病 殳	疒 殳
羿	羽 廾
衵	衣 日	衤 日
轶	车 失
唈	口 邑
垼	役 土
悒	心 邑	忄 邑
挹	手 邑	扌 邑	才 邑
栧	木 曳
栺	木 旨
欭	因 欠
浥	水 邑	氵 邑
浳	水 弋 肉	氵 弋 肉	水 弋 月	氵 弋 月
益	丷 一 八 皿
袣	衣 世	衤 世
谊	言 宜	讠 宜
陭	阜 奇	阝 奇
勚	贳 力
埶	坴 丸
埸	土 易
悥	言 心
掜	手 兒	扌 兒	才 兒
殹	医 殳
異	田 共
羛	羊 弗
翊	立 羽
翌	羽 立
訲	言 中	訁 中
訳	言 尺	訁 尺
豙	亠 丷 豕	立 豕
豛	豕 殳
逸	辵 免	辶 免
釴	金 弋	釒 弋
隿	弋 隹
幆	巾 曷
敡	易 攴
晹	日 易
棭	木 夜
殔	歹 隶
湙	水 奕	氵 奕
焲	火 夜
蛡	虫 羽
蛡	蟲 羽	虫 羽
詍	言 世	訁 世
跇	足 世
軼	車 失
鈠	金 殳	釒 殳
骮	骨 戈
亄	壹 乙	壹 乚
兿	丷 一 执 云
意	音 心
溢	水 益	氵 益
獈	犬 益	犭 益
痬	病 易	疒 易
睪	罒 幸
竩	立 宜
缢	丝 益	纟 益
義	羊 我
肄	匕 矢 聿
裔	衣 冏
裛	衣 邑
詣	言 旨	訁 旨
勩	貰 力
嫕	女 悘
廙	广 異
榏	木 益
潩	水 異	氵 異
瘗	病 夹	疒 夹
膉	肉 益	月 益
蓺	草 埶	艸 埶	艹 埶
蜴	虫 易
蜴	蟲 易	虫 易
靾	革 世
駅	馬 尺
億	人 意	亻 意
撎	手 壹	扌 壹	才 壹
槸	木 埶
毅	豙 殳	立 豕 殳
熠	火 習
熤	火 翌
熼	火 異
瘞	病 座	疒 座
誼	言 宜	訁 宜
镒	金 益	钅 益
鹝	鬲 鸟
鹢	益 鸟
黓	黑 戈
劓	鼻 刀	鼻 刂
圛	囗 睪
墿	土 睪
嬑	女 意
嬟	女 義
嶧	山 睪
憶	心 意	忄 意
懌	心 睪	忄 睪
曀	日 壹
殪	歹 壹
澺	水 意	氵 意
燚	火 火 火 火
燚	炎 炎
瘱	病 夾	疒 夾
瞖	殹 目
穓	禾 異
縊	絲 益	糹 益	糸 益
艗	舟 益
薏	草 意	艸 意	艹 意
螠	虫 益
螠	蟲 益	虫 益
褹	衣 埶	衤 埶
寱	宀 爿 臬
斁	睪 攴	睪 攵
曎	日 睪
檍	木 意
歝	睪 欠
燡	火 睪
燱	火 意
翳	殹 羽
翼	羽 異
臆	肉 意	月 意
貖	豸 益
賹	貝 益
鮨	魚 旨
癔	病 意	疒 意
藙	草 毅	艸 毅	艹 毅
藝	草 埶 云	艸 埶 云	艹 埶 云	草 執 云
贀	殹 貝
鎰	金 益	釒 益
镱	金 意	钅 意
繶	絲 意	糹 意	糸 意
繹	絲 睪	糹 睪	糸 睪
豷	豕 壹
霬	雨 異
鯣	魚 易
鶂	兒 鳥
鶃	鳥 兒
瀷	水 翼	氵 翼
蘙	草 翳	艸 翳	艹 翳
譯	言 睪	訁 睪
議	言 義	訁 義
醳	酉 睪
醷	酉 意
饐	食 壹
囈	口 藝
鐿	金 意	釒 意
鷁	益 鳥
鷊	鬲 鳥
懿	壹 恣
襼	衣 藝	衤 藝
驛	馬 睪
鷧	壹 鳥
虉	草 鷊	艸 鷊	艹 鷊
鷾	意 鳥
讛	言 藝	訁 藝
齸	齒 益
因	囗 大
阥	阜 水	阝 水
阴	阜 月	阝 月
侌	今 云
垔	西 土	覀 土
姻	女 因
洇	水 因	氵 因
茵	草 因	艸 因	艹 因
荫	草 阴	艸 阴	艹 阴
音	立 日	立 曰
骃	马 因
殷	丶 丿 彐 乛 殳	㐆 殳
氤	气 因
氤	氣 因	气 因
陰	阜 侌	阝 侌
凐	冫 垔	冰 垔
秵	禾 因
裀	衣 因	衤 因
铟	金 因	钅 因
陻	阜 垔	阝 垔
隂	阜 人 镸	阝 人 镸
喑	口 音
堙	土 西 土
婣	女 片 一 爿
愔	心 音	忄 音
筃	竹 因
絪	絲 因	糹 因	糸 因
歅	垔 欠
溵	水 殷	氵 殷
禋	示 垔	礻 垔
蒑	草 殷	艸 殷	艹 殷
蔭	草 陰	艸 陰	艹 陰
慇	殷 心
瘖	病 音	疒 音
銦	金 因	釒 因
緸	絲 垔	糹 垔	糸 垔
鞇	革 因
諲	言 垔	訁 垔
霒	雲 今
駰	馬 因
噾	口 窨
闉	門 垔
霠	雨 立 今
韾	殸 音
冘	冖 人	冖 丿 乚
乑	丿 丨 丿 丿 丶 乀
吟	口 今
犾	犬 犬	犭 犬
苂	草 火	艸 火	艹 火
斦	斤 斤
烎	干 干 火	开 火
垠	土 艮
泿	水 艮	氵 艮
圁	囗 言
峾	沂 山
狺	犬 言	犭 言
珢	玉 艮	王 艮
荶	草 吟	艸 吟	艹 吟
訔	山 言
訚	门 言
婬	女 爪 壬	女 爫 壬
寅	宀 一 由 八
崟	山 金
崯	山 金
淫	水 爪 壬	氵 爫 壬
訡	言 今	訁 今
银	金 艮	钅 艮
鈝	金 牛	釒 牛
龂	齿 斤
滛	水 爪 缶	氵 爫 缶
碒	石 金
鄞	堇 邑	堇 阝
夤	夕 寅
蔩	草 寅	艸 寅	艹 寅
銀	金 艮	釒 艮
噖	口 琴
殥	歹 寅
璌	玉 寅	王 寅
誾	門 言
嚚	口 口 臣 口 口
檭	木 銀
蟫	虫 覃
蟫	蟲 覃	虫 覃
霪	雨 水 爪 壬	雨 氵 爫 壬
齗	齒 斤
鷣	覃 鳥
尹	尸 一	彐 丿
引	弓 丨
吲	口 引
饮	食 欠	饣 欠
蚓	虫 引
蚓	蟲 引	虫 引
赺	走 今
隐	阜 急	阝 急
淾	金 水
鈏	金 引	釒 引
飲	食 欠	飠 欠
隠	阜 爪 彐 心	阝 爫 彐 心
靷	革 引
飮	食 欠
朄	申 柬
輑	車 君
磤	石 殷
趛	走 金
檃	爪 工 彐 木	爫 工 彐 木
瘾	病 隐	疒 隐
隱	阜 爪 工 彐 心	阝 爫 工 彐 心	阜 㥯	阝 㥯
嶾	山 爪 工 彐 心	山 爫 工 彐 心	山 㥯
濥	水 夤	氵 夤
濦	水 爪 工 彐 心	氵 爫 工 彐 心	水 㥯	氵 㥯
螾	虫 寅
螾	蟲 寅	虫 寅
蘟	草 隱	艸 隱	艹 隱
櫽	隱 木
癮	病 隱	疒 隱
讔	言 隱	訁 隱
印	卬 一	丿 𠄌 一 卩
茚	草 印	艸 印	艹 印
洕	水 八 肉	氵 水 八 肉	水 八 月	氵 八 月
胤	丿 幺 肉 乚	丿 幺 月 乚
垽	沂 土
堷	土 音
湚	水 胤	氵 胤
猌	來 犬
廕	广 陰
酳	酉 幺 肉	酉 幺 月
慭	来 犬 心
癊	病 陰	疒 陰
憖	猌 心
憗	心 來 攴	來 攵
鮣	魚 印
懚	心 爪 工 彐 心	忄 爫 工 彐 心	心 㥯	忄 㥯
檼	木 爪 工 彐 心	木 爫 工 彐 心	木 㥯
应	广 丷 亠	广 丶 丶 丿 一
応	广 心
英	草 央	艸 央	艹 央
偀	人 英	亻 英
桜	木 小 女
莺	草 冖 鸟	艸 冖 鸟	艹 冖 鸟
莺	艹 冖 鸟
啨	口 青
婴	贝 贝 女
媖	女 英
渶	水 英	氵 英
绬	丝 英	纟 英
朠	月 英
煐	火 英
瑛	玉 英	王 英
嫈	火 火 冖 女	𤇾 女
碤	石 英
锳	金 英	钅 英
嘤	口 婴
撄	手 婴	扌 婴
甇	火 火 冖 瓦	𤇾 瓦
緓	絲 英	糹 英	糸 英
缨	丝 婴	纟 婴
罂	贝 贝 缶
蝧	虫 英
蝧	蟲 英	虫 英
賏	貝 貝
樱	木 婴
璎	玉 婴	王 婴
罃	火 火 冖 缶	𤇾 缶
褮	火 火 冖 衣	𤇾 衣
鍈	金 英	釒 英
霙	雨 英
鴬	小 冖 鳥
鹦	婴 鸟
嬰	貝 貝 女
應	广 人 隹 心	广 亻 隹 心	广 倠 心
膺	广 人 隹 肉	广 人 隹 月	广 亻 隹 肉	广 倠 肉
韺	音 英
甖	賏 瓦	貝 貝 瓦
鹰	广 人 隹 鸟	广 亻 隹 鸟	广 倠 鸟
鶧	英 鳥
嚶	口 嬰
孆	女 嬰
孾	子 嬰
攖	手 嬰	扌 嬰	才 嬰
罌	貝 貝 缶
蘡	草 真 真 女	艸 真 真 女	艹 真 真 女
譍	广 倠 言
櫻	木 嬰
瓔	玉 嬰	王 嬰
礯	石 縈
譻	賏 言
鶯	火 火 冖 鳥	𤇾 鳥
鑍	賏 金
纓	絲 嬰	糹 嬰	糸 嬰
蠳	蟲 嬰	虫 嬰
鷪	目 目 冖 鳥
鷹	广 人 隹 鳥	广 亻 隹 鳥	广 倠 鳥
鸎	賏 鳥
鸚	嬰 鳥
盁	乃 皿
迎	辵 卬	辶 卬
茔	草 冖 土	艸 冖 土	艹 冖 土
盈	乃 又 皿	夃 皿
荧	草 冖 火	艸 冖 火	艹 冖 火
莹	艹 冖 玉
営	小 冖 呂
萤	草 冖 虫	艸 冖 虫	艹 冖 虫
萤	艹 冖 虫
营	草 冖 吕	艸 冖 吕	艹 冖 吕
营	艹 冖 吕
萦	草 冖 丝	艹 冖 丝
蛍	小 冖 蟲	小 冖 虫
溁	水 荣	氵 荣
萾	草 盈	艸 盈	艹 盈
僌	人 車 攴	亻 車 攵
塋	火 火 冖 土	𤇾 土
楹	木 盈
滢	水 莹	氵 莹
蓥	草 冖 金	艸 冖 金	艹 冖 金
潆	水 萦	氵 萦
熒	火 火 冖 火	𤇾 火
蝇	虫 黾
瑩	火 火 冖 玉	𤇾 玉
蝿	蟲 曰 电	蟲 田 电	虫 曰 电	虫 田 电
嬴	亡 口 月 女 凡
營	火 火 冖 呂	𤇾 呂
縈	火 火 冖 絲	火 火 冖 糸	𤇾 絲	𤇾 糸
螢	火 火 冖 蟲	火 火 冖 虫	𤇾 蟲	𤇾 虫
濙	水 熒	氵 熒
濚	水 榮	氵 榮
濴	水 滎	氵 滎
藀	草 熒	艸 熒	艹 熒
覮	火 火 冖 見	𤇾 見
謍	火 火 冖 言
謍	火 火 冖 言	𤇾 言
赢	亡 口 月 贝 凡
瀅	水 瑩	氵 瑩
鎣	火 火 冖 金	𤇾 金
攍	手 嬴	扌 嬴	才 嬴
瀛	水 嬴	氵 嬴
瀠	水 縈	氵 縈
瀯	水 營	氵 營
蠅	蟲 黽	虫 黽
櫿	木 營
瀴	水 嬰	氵 嬰
贏	亡 口 月 貝 凡
籝	竹 嬴
籯	竹 贏
矨	矢 夭
郢	呈 邑	呈 阝
浧	水 呈	氵 呈
梬	木 甹
颍	匕 水 页
颕	匕 示 页
颖	匕 禾 页
摬	手 竟	扌 竟	才 竟
影	景 彡
潁	匕 水 頁
瘿	病 婴	疒 婴
穎	匕 禾 頁
頴	匕 示 頁
巊	山 嬰
廮	广 嬰
鐛	金 景	釒 景
癭	病 嬰	疒 嬰
映	日 央
暎	日 英
硬	石 更
媵	肉 丷 夫 女	月 丷 夫 女	肉 𠔉 女	月 𠔉 女
媵	肉 丷 夫 女	月 𠔉 女	肉 𠔉 女	月 𠔉 女
膡	肉 眷	月 眷
噟	广 倠 口	广 人 隹 口	广 亻 隹 口
鞕	革 更
鱦	魚 黽
哟	口 约 喲
唷	口 育
喲	口 約
佣	人 用	亻 用
拥	手 用	扌 用	才 用
痈	病 用	疒 用
邕	巛 邑
庸	广 聿 冃	广 聿 冂 二	广 肀 冂 二	广 用 冂 二
傭	人 庸	亻 庸
嗈	口 邕
鄘	庸 邑	庸 阝
雍	亠 乡 隹
墉	土 庸
嫞	女 庸
慵	心 庸	忄 庸
滽	水 庸	氵 庸
槦	木 庸
牅	爿 庸
噰	口 雍
壅	雍 土
擁	手 雍	扌 雍	才 雍
澭	水 雍	氵 雍
郺	多 邕
镛	金 庸	钅 庸
臃	肉 雍	月 雍
癕	病 雍	疒 雍
雝	邕 隹
鏞	金 庸	釒 庸
鳙	鱼 庸
廱	广 雝
灉	水 雝	氵 雝
饔	雍 食
鱅	魚 庸
鷛	庸 鳥
癰	病 雝	疒 雝
喁	口 禺
揘	手 皇	扌 皇	才 皇
颙	禺 页
顒	禺 頁
鰫	魚 容
永	丶 一 水
甬	龴 用
咏	口 永
泳	水 永	氵 永
俑	人 甬	亻 甬
勇	甬 力
勈	甬 力
栐	木 永
埇	土 甬
悀	心 甬	忄 甬
柡	木 二 水
涌	水 甬	氵 甬
恿	甬 心
傛	人 容	亻 容
惥	臾 心
愑	心 勇	忄 勇
湧	水 勇	氵 勇
硧	石 甬
詠	言 永	訁 永
塎	土 容
嵱	山 容
彮	容 彡
愹	心 容	忄 容
蛹	虫 甬
蛹	蟲 甬	虫 甬
慂	涌 心
踊	足 甬
禜	火 火 冖 示	𤇾 示
鲬	鱼 甬
踴	足 勇
鯒	魚 甬
用	月 丨	冂 十 一
苚	草 用	艸 用	艹 用
醟	火 火 冖 酉	𤇾 酉
优	人 尤	亻 尤
忧	心 尤	忄 尤
攸	人 丨 攴	亻 丨 攵
呦	口 幼
怮	心 幼	忄 幼
泑	水 幼	氵 幼
幽	山 幺 幺
逌	辵 卣	辶 卣
悠	攸 心
麀	鹿 匕
滺	水 悠	氵 悠
憂	一 白 冖 心 夕	一 白 冖 心 夂
優	人 憂	亻 憂
鄾	憂 邑	憂 阝
嚘	口 憂
瀀	水 憂	氵 憂
櫌	木 憂
纋	絲 憂	糹 憂	糸 憂
耰	耒 憂
尢	一 人	一 丿 乚
尤	尢 丶	一 丿 乚 丶
由	囗 十
沋	水 尤	氵 尤
犹	犬 尤	犭 尤
邮	由 邑	由 阝
油	水 由	氵 由
肬	肉 尤	月 尤
怣	失 心
斿	方 丿 一 子
疣	病 尤	疒 尤
峳	山 攸
浟	水 攸	氵 攸
秞	禾 由
莜	草 攸	艸 攸	艹 攸
莸	草 犹	艸 犹	艹 犹
郵	垂 邑	垂 阝
铀	金 由	钅 由
偤	人 酋	亻 酋
蚰	虫 由
蚰	蟲 由	虫 由
訧	言 尤	訁 尤
逰	辵 手 丿 一 子	辶 手 丿 一 子
游	水 斿	氵 斿
猶	犬 酋	犭 酋
遊	辵 斿	辶 斿
鱿	鱼 尤
楢	木 酋
猷	酋 犬
鈾	金 由	釒 由
鲉	鱼 由
輏	車 酉
駀	馬 尤
蕕	草 猶	艸 猶	艹 猶
蝣	虫 斿
蝣	蟲 斿	虫 斿
魷	魚 尤
輶	車 酋
鮋	魚 由
櫾	木 爪 缶 系	木 爫 缶 系
友	一 丿 又
有	一 丿 月
卣	卜 囙
苃	草 友	艸 友	艹 友
酉	西 一
羑	羊 久
庮	广 酉
栯	木 有
羐	艹 土 久
莠	草 秀	艸 秀	艹 秀
梄	木 酉
聈	耳 幼
脜	肉 一 自	月 一 自
铕	金 有	钅 有
湵	水 羑	氵 羑
禉	示 酋	礻 酋
蜏	虫 秀
蜏	蟲 秀	虫 秀
銪	金 有	釒 有
槱	木 酉 火	木 酉 灬
牖	片 戶 甫
黝	黑 幼
懮	心 憂	忄 憂
又	乛 丿
右	一 丿 口
幼	幺 力
佑	人 右	亻 右
侑	人 有	亻 有
狖	犬 穴	犭 穴
糿	絲 刀	糹 刀	糸 刀
哊	口 有
囿	囗 有
姷	女 有
宥	宀 有
峟	山 有
柚	木 由
牰	牛 由	牜 由
祐	示 右	礻 右
诱	言 秀	讠 秀
迶	辵 有	辶 有
唀	口 秀
蚴	虫 幼
蚴	蟲 幼	虫 幼
亴	亠 口 冂 土 九
亴	亠 口 冖 土 九
貁	豸 穴
釉	采 由	釆 由
酭	酉 有
誘	言 秀	訁 秀
鼬	鼠 由
扜	手 于	扌 于	才 于
纡	丝 于	纟 于
迂	辵 于	辶 于
迃	辵 亏	辶 亏
穻	穴 于
陓	阜 夸	阝 夸
紆	絲 于	糹 于	糸 于
虶	虫 于
虶	蟲 于	虫 于
唹	口 於
淤	水 於	氵 於
盓	汙 皿
瘀	病 於	疒 於
箊	竹 於
亐	一 丂
于	二 亅
邘	于 邑	于 阝
伃	人 予	亻 予
余	人 于 八
妤	女 予
扵	手 仒	扌 仒	才 仒
杅	木 于
欤	与 欠
玗	玉 于	王 于
玙	玉 与	王 与
於	方 人 冫
盂	于 皿
臾	臼 人
衧	衣 于	衤 于
鱼	刀 田 一
俞	人 一 月 刀	人 一 月 刂
兪	入 一 肉 巜	入 一 月 巜
禺	甲 禸	日 禸
竽	竹 于
舁	臼 廾
茰	草 由 乂	艸 由 乂	艹 由 乂
娛	女 吳
娯	女 呉
娱	女 吴
桙	木 牟
狳	犬 余	犭 余
谀	言 臾	讠 臾
酑	酉 于
馀	饣 余
渔	水 鱼	氵 鱼
萸	草 臾	艸 臾	艹 臾
隅	阜 禺	阝 禺
雩	雨 亏
魚	刀 田 火	刀 田 灬
堣	土 禺
堬	土 俞
崳	山 俞
嵎	山 禺
嵛	山 俞
愉	心 俞	忄 俞
揄	手 俞	扌 俞	才 俞
楰	木 臾
渝	水 俞	氵 俞
湡	水 禺	氵 禺
畭	田 余
硢	石 余
腴	肉 臾	月 臾
萮	草 俞	艸 俞	艹 俞
逾	辵 俞	辶 俞
骬	骨 于
愚	禺 心
楡	木 俞
榆	木 俞
歈	俞 欠
牏	片 俞
瑜	玉 俞	王 俞
艅	舟 余
虞	虎 吳	虍 吳
虞	虎 吴	虍 吴
觎	俞 见
漁	水 魚	氵 魚
睮	目 俞
窬	穴 俞
舆	臼 车 一 八
褕	衣 俞	衤 俞
歶	此 禺
羭	羊 俞
蕍	草 渝	艸 渝	艹 渝
蝓	虫 俞
蝓	蟲 俞	虫 俞
諛	言 臾	訁 臾
雓	余 隹
餘	食 余
餘	食 余	飠 余
嬩	女 與
澞	水 虞	氵 虞
覦	俞 見
踰	足 俞
歟	與 欠
璵	玉 與	王 與
螸	欲 虫
螸	欲 蟲	欲 虫
輿	臼 車 一 八
鍝	金 禺	釒 禺
謣	言 雩	訁 雩
髃	骨 禺
鮽	魚 余
旟	方 丿 一 與
籅	竹 與
騟	馬 俞
蘛	草 甚 育	艸 甚 育	艹 甚 育
鰅	魚 禺
鷠	魚 鳥
鸆	虞 鳥
与	一 乛 一
予	龴 乛 亅
伛	人 区	亻 区
宇	宀 于
屿	山 与
羽	习 习
雨	一 冂 丨 丶 丶 丶 丶
俁	人 吳	亻 吳
俣	人 吴	亻 吴
禹	丿 口 冂 厶
语	言 吾	讠 吾
圄	囗 吾
峿	山 吾
祤	示 羽	礻 羽
偊	人 禹	亻 禹
匬	匚 俞
圉	囗 幸
庾	广 臾
敔	吾 攴	吾 攵
鄅	禹 邑	禹 阝
斞	臾 斗
萭	草 禹	艸 禹	艹 禹
傴	人 區	亻 區
寙	宀 瓜 瓜
楀	木 禹
瑀	玉 禹	王 禹
瘐	病 臾	疒 臾
與	臼 一 乛 丶 一 八
語	言 吾	訁 吾
窳	穴 瓜 瓜
鋙	金 吾	釒 吾
頨	羽 頁
龉	齿 吾
噳	口 虞
嶼	山 與
懙	心 與	忄 與
貐	豸 俞
斔	文 虫 臾
斔	文 蟲 臾	文 虫 臾
麌	鹿 吳
蘌	草 禦	艸 禦	艹 禦
齬	齒 吾
肀	彐 丨
玉	王 丶
驭	马 又
圫	土 乇
聿	彐 二 丨
芋	草 于	艸 于	艹 于
芌	草 亏	艸 亏	艹 亏
妪	女 区
忬	心 予	忄 予
饫	饣 夭
育	亠 厶 肉	亠 厶 月
郁	有 邑	有 阝
昱	日 立
狱	犬 言 犬	犭 讠 犬
秗	禾 夭
茟	草 聿	艸 聿	艹 聿
俼	人 育	亻 育
峪	山 谷
彧	或 彡	或 丿 丿
浴	水 谷	氵 谷
砡	石 玉
钰	金 玉	钅 玉
预	予 页
喐	口 郁
域	土 或
堉	土 育
悆	余 心
惐	心 或	忄 或
欲	谷 欠
淢	水 或	氵 或
淯	水 育	氵 育
袬	衣 台
谕	言 俞	讠 俞
逳	辵 育	辶 育
阈	门 或
喅	口 昱
喩	口 俞
喻	口 俞
媀	女 禺
寓	宀 禺
庽	广 禺
御	彳 卸
棛	木 育
棜	木 於
棫	木 或
焴	火 育
琙	玉 或	王 或
矞	矛 冏
硲	石 谷
裕	衣 谷	衤 谷
遇	辵 禺	辶 禺
飫	食 夭
馭	馬 又
鹆	谷 鸟
愈	俞 心
滪	水 预	氵 预
煜	火 日 立
稢	禾 或
罭	网 或	罒 或
蒮	草 隺	艸 隺	艹 隺
蓣	草 预	艸 预	艹 预
誉	兴 言
鈺	金 玉	釒 玉
預	予 頁
嫗	女 區
嶎	山 尉
戫	有 或
毓	每 亠 厶 川	每 巟	每 㐬
獄	犬 言 犬	犭 訁 犬
瘉	病 俞	疒 俞
緎	絲 或	糹 或	糸 或
蜟	虫 育
蜟	蟲 育	虫 育
蜮	虫 或
蜮	蟲 或	虫 或
輍	車 谷
銉	金 聿	釒 聿
噊	口 矞
慾	欲 心
潏	水 矞	氵 矞
稶	禾 彧
蓹	草 御	艸 御	艹 御
薁	草 奧	艸 奧	艹 奧
豫	予 象
遹	辵 矞	辶 矞
鋊	金 谷	釒 谷
鳿	玉 鳥	王 鳥
澦	水 預	氵 預
燏	火 矞
燠	火 奧
蕷	草 預	艸 預	艹 預
諭	言 俞	訁 俞
錥	金 育	釒 育
閾	門 或
鴥	鳥 穴
鴧	宂 鳥
鴪	穴 鳥
儥	人 賣	亻 賣
礇	石 奧
禦	御 示
魊	鬼 或
鹬	矞 鸟	矛 冏 鸟
癒	病 愈	疒 愈
礖	石 與
礜	與 石
穥	禾 與
篽	竹 御
繘	絲 矞	糹 矞	糸 矞
醧	酉 區
鵒	谷 鳥
櫲	木 豫
饇	食 區
譽	與 言
轝	與 車
鐭	金 奥	釒 奥
霱	雨 矞
欎	棥 冖 艮 寸
驈	馬 矞
鬻	粥 鬲
籞	竹 禦
鱊	魚 矞
鷸	矞 鳥	矛 冏 鳥
鸒	與 鳥
欝	棥 网 艮 寸	棥 罒 艮 寸	棥 罒 艮 寸
龥	龠 頁
軉	身 寶
鬰	棥 冖 鬯 彡
鬱	木 缶 木 冖 鬯 彡
灪	水 鬱	氵 鬱
籲	籥 頁	竹 龠 頁
爩	火 鬱
囦	囗 水
鸢	弋 鸟
剈	肙 刀	肙 刂
冤	冖 兔
悁	心 肙	忄 肙
眢	夗 目
鸳	夗 鸟
寃	宀 兔
渁	水 水	氵 水
渆	水 并 刀	氵 并 刂	洴 刀	洴 刂
渊	水 丿 米 丨	氵 片 一 爿
渕	水 关 刀	氵 关 刂	浂 刀	浂 刂
惌	宛 心	宀 怨
淵	水 片 一 爿	氵 片 一 爿
葾	草 怨	艸 怨	艹 怨	苑 心
棩	木 片 一 爿
蒬	草 冤	艸 冤	艹 冤
蜎	虫 肙	虫 口 月
蜎	蟲 肙	虫 肙
裷	衣 卷	衤 卷
鹓	宛 鸟
箢	竹 宛
鳶	弋 鳥
蜵	蟲 片 一 爿	虫 片 一 爿
駌	夗 馬
鴛	夗 鳥
鵷	宛 鳥
灁	水 門 泉	氵 門 泉
鼘	鼓 片 一 爿
鼝	淵 鼓
元	二 儿
円	冂 丄
贠	厶 贝
邧	元 邑	元 阝
员	口 贝
园	囗 元
沅	水 元	氵 元
杬	木 元
垣	土 亘
爰	爪 一 友	爫 一 友
貟	厶 貝
原	厂 白 小	厂 泉
員	口 貝
圆	囗 员
笎	竹 元
蚖	虫 元
蚖	蟲 元	虫 元
袁	土 口 衣
厡	厂 泉
圎	囗 貟
援	手 爰	扌 爰	才 爰
湲	水 爰	氵 爰
猨	犬 爰	犭 爰
缘	丝 彖	纟 彖
鼋	元 黾
園	囗 袁
圓	囗 員
塬	土 原
媴	女 袁
嫄	女 原
源	水 原	氵 原
溒	水 袁	氵 袁
猿	犬 袁	犭 袁
獂	犬 原	犭 原
蒝	草 原	艸 原	艹 原
榞	木 原
榬	木 袁
辕	车 袁
緣	絲 彖	糹 彖	糸 彖
縁	絲 緣	糹 緣	糸 緣
蝝	虫 彖
蝝	蟲 彖	虫 彖
蝯	虫 爰
蝯	蟲 爰	虫 爰
魭	魚 元
橼	木 缘
羱	羊 原
薗	草 園	艸 園	艹 園
螈	虫 原
螈	蟲 原	虫 原
謜	言 原	訁 原
轅	車 袁
黿	元 黽
鎱	金 袁	釒 袁
櫞	木 緣
邍	辵 备 录	辶 备 录
騵	馬 原
鶢	爰 鳥
鶰	員 鳥
厵	原 原 原
远	辵 袁	辶 元
盶	目 元
逺	辵 土 𠃊 衣	辶 土 𠃊 衣
遠	辵 袁	辶 袁
鋺	金 宛	釒 宛
夗	夕 卩	夕 㔾
肙	口 月
妴	夗 女
苑	草 夗	艸 夗	艹 夗
怨	夗 心	夕 卩 心	夕 㔾 心
院	阜 完	阝 完
垸	土 完
衏	行 元	彳 元 亍
傆	人 原	亻 原
媛	女 爰
掾	手 彖	扌 彖	才 彖
瑗	玉 爰	王 爰
禐	示 爰	礻 爰
愿	原 心
裫	衣 片 一 爿	衤 片 一 爿
褑	衣 爰	衤 爰
褤	衣 袁	衤 袁
噮	口 睘
願	原 頁
曰	口 一
曱	口 丅
约	丝 勺	纟 勺
約	絲 勺	糹 勺	糸 勺
箹	竹 約
矱	矢 蒦
彟	寻 蒦
彠	尋 蒦
月	冂 一 一
刖	月 刀	月 刂
妜	女 夬
岄	山 月
抈	手 月	扌 月	才 月
礿	示 勺	礻 勺
岳	丘 山
玥	玉 月	王 月
恱	心 兊	忄 兊
悅	心 兌	忄 兌
悦	心 兑	忄 兑
蚎	虫 日
蚎	蟲 日	虫 日
蚏	虫 月
蚏	蟲 月	虫 月
軏	車 兀
钺	金 戉	钅 戉
阅	门 兑
捳	手 岳	扌 岳	才 岳
跀	足 月
跃	足 夭
粤	丶 冂 米 亏
越	走 戉
鈅	金 月	釒 月
粵	丶 冂 采 亏	丶 冂 釆 亏
鉞	金 戉	釒 戉
閱	門 兌
閲	門 兑
樾	木 越
篗	竹 隻
嶽	山 獄
龠	人 一 口 口 口 冊
籆	竹 蒦
瀹	水 龠	氵 龠
蘥	草 龠	艸 龠	艹 龠
黦	黑 宛
爚	火 火 龠
禴	示 龠	礻 龠
躍	足 翟
籥	竹 龠
鸑	獄 鳥
籰	竹 矍
鸙	龠 鳥
晕	日 军
缊	丝 昷	纟 昷
蒀	草 昷	艸 昷	艹 昷
暈	日 軍
氲	气 昷
煴	火 昷
蒕	草 昷	艸 昷	艹 昷
氳	氣 昷	气 昷
奫	大 淵
蝹	虫 昷
蝹	蟲 昷	虫 昷
赟	斌 贝
頵	君 頁
馧	香 昷
贇	斌 貝
云	二 厶
勻	勹 二
匀	勹 冰	勹 冫
囩	囗 云
妘	女 云
沄	水 云	氵 云
纭	丝 云	纟 云
芸	草 云	艸 云	艹 云
昀	日 勻	日 匀
畇	田 勻
畇	田 匀
眃	目 云
秐	禾 云
郧	员 邑	员 阝
涢	水 员	氵 员
紜	絲 云	糹 云	糸 云
耘	耒 云
耺	耳 云
鄖	員 邑	員 阝
雲	雨 云
愪	心 員	忄 員
溳	水 員	氵 員
筠	竹 均
筼	竹 员
蒷	草 員	艸 員	艹 員
熉	火 員
澐	水 雲	氵 雲
蕓	草 雲	艸 雲	艹 雲
鋆	均 金
橒	木 雲
篔	竹 員
縜	絲 員	糹 員	糸 員
允	厶 儿
阭	阜 允	阝 允
夽	大 云
抎	手 云	扌 云	才 云
狁	犬 允	犭 允
陨	阜 员	阝 员
荺	草 均	艸 均	艹 均
殒	歹 员
喗	口 軍
鈗	金 允	釒 允
隕	阜 員	阝 員
殞	歹 員
褞	衣 昷	衤 昷
馻	馬 允
磒	石 員
賱	貝 軍
霣	雨 員
齫	齒 困
齳	齒 軍
孕	乃 子
运	辵 云	辶 云
枟	木 云
郓	军 邑	军 阝
恽	心 军	忄 军
鄆	軍 邑	軍 阝
酝	酉 云
傊	人 員	亻 員
惲	心 軍	忄 軍
愠	心 昷	忄 昷
運	辵 軍	辶 軍
慍	心 囚 皿	忄 囚 皿
腪	肉 軍	月 軍
韫	韦 昷
韵	音 匀
熅	火 昷
熨	尉 火
緷	絲 軍	糹 軍	糸 軍
緼	絲 昷	糹 昷	糸 昷
蕴	草 缊	艸 缊	艹 缊
縕	絲 昷	糹 昷	糸 昷
薀	草 溫	艸 溫	艹 溫
醖	酉 昷
醞	酉 昷
餫	食 軍
藴	草 縕	艸 縕	艹 縕
韗	韋 軍
韞	韋 昷
蘊	草 縕	艸 縕	艹 縕
韻	音 員
帀	一 巾
匝	匚 巾
沞	水 帀	氵 帀
迊	辵 币	辶 币
咂	口 匝
拶	手 巛 夕	扌 巛 夕	才 巛 夕
紥	扎 糸
紮	札 絲	札 糸
鉔	金 匝	釒 匝
魳	魚 帀
臜	肉 赞	月 赞
臢	肉 贊	月 贊
杂	九 木
杂	九 木	九 朩
沯	水 石
砸	石 匝
偺	人 昝	亻 昝
喒	口 昝
韴	音 帀
雑	杂 隹
磼	石 集
襍	衣 集	衤 集
雜	卒 八 隹
囋	口 贊
囐	口 獻
雥	隹 隹 隹
咋	口 乍
災	巛 火
灾	宀 火
甾	巛 田
哉	十 戈 口	土 戈 口	𢦏 口
栽	十 戈 木	土 戈 木	𢦏 木
烖	十 戈 火	土 戈 火	𢦏 火
菑	草 甾	艸 甾	艹 甾
渽	水 哉	氵 哉
溨	水 栽	氵 栽
賳	貝 哉
宰	宀 辛
崽	山 思
再	一 冂 十 一
再	一 冂 十 一	一 冉
在	一 人 土	一 亻 土
扗	手 土	扌 土	才 土
洅	水 再	氵 再
载	十 戈 车	土 戈 车	𢦏 车
傤	人 载	亻 载
載	十 戈 車	土 戈 車	𢦏 車
酨	十 戈 酉	土 戈 酉	𢦏 酉
儎	人 載	亻 載
縡	絲 宰	糹 宰	糸 宰
兂	匚 丿 乚
旡	匚 丿 乚
糌	米 夂 人 日
簪	竹 旡 旡 日	竹 朁
簮	竹 夫 夫 日
鐕	金 旡 旡 日	釒 旡 旡 日	金 朁	釒 朁
鐟	金 替	釒 替
咱	口 自
昝	处 日
桚	木 巛 夕
寁	宀 疌
揝	手 昝	扌 昝	才 昝
噆	口 旡 旡 日	口 朁
撍	手 旡 旡 日	扌 旡 旡 日	才 旡 旡 日	手 朁	扌 朁	才 朁
儧	人 賛	亻 賛
攅	手 賛	扌 賛	才 賛
攒	手 赞	扌 赞	才 赞
儹	人 贊	亻 贊
攢	手 贊	扌 贊	才 贊
趱	走 赞
趲	走 贊
暂	斩 日
暫	斬 日
賛	夫 夫 貝
赞	先 先 贝
錾	斩 金
鄼	賛 邑	賛 阝
濽	水 賛	氵 賛
蹔	斬 足
瓉	玉 賛	王 賛
贊	先 先 貝
鏨	斬 金
瓒	玉 赞	王 赞
酇	贊 邑	贊 阝
灒	水 贊	氵 贊
讃	言 賛	訁 賛
瓚	玉 贊	王 贊
禶	示 贊	礻 贊
襸	衣 贊	衤 贊
讚	言 贊	訁 贊
饡	食 贊
匨	匚 壯
牂	爿 羊
羘	肉 羊	月 羊
赃	贝 庄
賍	貝 庄
臧	一 爿 乀 丿 丶 臣	爿 戊 臣
蔵	草 戉 臣	艸 戉 臣	艹 戉 臣
賘	貝 广 圡	貝 庄 丶
贓	貝 臧
髒	骨 葬
贜	貝 藏
驵	马 且
駔	馬 且
奘	壯 大
弉	壯 廾
脏	肉 庄	月 庄
塟	草 死 土	艸 死 土	艹 死 土
葬	草 死 廾	艸 死 廾	艹 死 廾
銺	壯 金
臓	肉 蔵	月 蔵
臟	肉 藏	月 藏
傮	人 曹	亻 曹
遭	辵 曹	辶 曹
糟	米 曹
蹧	足 曹
醩	酉 曹
凿	丵 凵
鑿	丵 臼 殳 金
早	日 十
枣	朿 冰	朿 冫
蚤	叉 丶 虫
蚤	叉 丶 蟲	叉 丶 虫
棗	朿 朿
澡	水 品 木	氵 品 木	氵 喿
璪	玉 喿	王 喿
薻	草 漅	艸 漅	艹 漅
繰	絲 喿	糹 喿	糸 喿
藻	草 澡	艸 澡	艹 澡
灶	火 土
皁	白 十
皂	白 七
唕	口 早
唣	口 皂
造	辵 告	辶 告
梍	木 白 七
喿	口 口 口 木
慥	心 造	忄 造
煰	火 品
艁	舟 告
噪	口 喿	口 品 木
簉	竹 造
燥	火 品 木	火 喿
譟	言 喿	訁 喿
趮	走 喿
躁	足 品 木	足 喿
竈	穴 土 黽
则	贝 刀	贝 刂
択	手 尺	扌 尺	才 尺
沢	水 尺	氵 尺
择	手 又 二 丨	扌 又 二 丨	才 又 二 丨
泎	水 乍	氵 乍
泽	水 又 二 丨	氵 又 二 丨
责	丰 贝
迮	辵 乍	辶 乍
則	貝 刀	貝 刂
唶	口 昔
啧	口 责
帻	巾 责
笮	竹 乍
舴	舟 乍
責	丰 貝
溭	水 畟	氵 畟
矠	矛 昔
嘖	口 責
嫧	女 責
幘	巾 責
箦	竹 责
樍	木 責
歵	止 責
諎	言 昔	訁 昔
赜	𦣞 责	匚 丨 口 丨 责
擇	手 睪	扌 睪	才 睪
澤	水 睪	氵 睪
皟	白 責
瞔	目 責
簀	竹 責
礋	石 睪
襗	衣 睪	衤 睪
謮	言 責	訁 責
蠌	蟲 睪	虫 睪
齚	齒 乍
齰	齒 昔
鸅	睪 鳥
夨	𠃊 大
仄	厂 人
庂	广 人
汄	水 人	氵 人
昃	日 仄
昗	日 六
捑	手 日 夨	扌 日 夨	才 日 夨
崱	山 則
贼	贝 戎
戝	貝 戈
賊	貝 戎
鲗	鱼 则
鯽	魚 即
蠈	賊 蟲	賊 虫
鰂	魚 則
鱡	魚 賊
怎	乍 心
谮	言 旡 旡 日	讠 旡 旡 日	言 朁	讠 朁
譖	言 旡 旡 日	訁 旡 旡 日	言 朁	訁 朁
譛	言 替	訁 替
増	土 曽
鄫	曾 邑	曾 阝
增	土 曾
憎	心 曽	忄 曽	心 曾	忄 曾
缯	丝 曾	纟 曾
橧	木 曾
熷	火 曾
璔	玉 曾	王 曾
矰	矢 曾
磳	石 曾
罾	网 曾	罒 曾
繒	絲 曾	糹 曾	糸 曾
譄	言 曾	訁 曾
锃	金 呈	钅 呈
鋥	金 呈	釒 呈
甑	曽 瓦	曾 瓦
赠	贝 曾
贈	貝 曽	貝 曾
扎	手 乚	扌 乚
扎	手 乚	扌 乚	才 乚
吒	口 宅
抯	手 且	扌 且	才 且
奓	大 多
挓	手 宅	扌 宅	才 宅
柤	木 且
査	木 且
哳	口 折
偧	人 大 多	亻 大 多	人 奓	亻 奓
喳	口 查
揸	手 查	扌 查	才 查
渣	水 查	氵 查
楂	木 查
劄	答 刀	答 刂
摣	手 虘	扌 虘	才 虘
皶	查 皮
樝	木 虘
觰	角 者
皻	虘 皮
譇	言 奢	訁 奢
齄	鼻 查
齇	鼻 虘
札	木 乚
甴	口 丄
闸	门 甲
蚻	札 虫
蚻	札 蟲	札 虫
铡	金 则	钅 则
煠	火 枼
牐	片 臿
閘	門 甲
箚	竹 合 刀	竹 合 刂
耫	耒 責
鍘	金 則	釒 則
譗	言 答	訁 答
厏	厂 乍
拃	手 乍	扌 乍	才 乍
苲	草 乍	艸 乍	艹 乍
眨	目 乏
砟	石 乍
鲊	鱼 乍
鲝	羊 鱼
踷	足 者
鮓	魚 乍
鮺	羊 魚
乍	丿 丅 二
灹	火 乇
诈	言 乍	讠 乍
咤	口 宅
咤	口 宅 吒
柞	木 乍
栅	木 册
炸	火 乍
宱	宀 作
痄	病 乍	疒 乍
蚱	虫 乍
蚱	蟲 乍	虫 乍
溠	水 差	氵 差
詐	言 乍	訁 乍
搾	手 窄	扌 窄	才 窄
榨	木 窄
霅	雨 言
醡	酉 窄
捚	手 里	扌 里	才 里
斋	文 而
斎	文 丿 二 小 丨
摘	手 啇	扌 啇	才 啇
榸	木 埋
齋	齊 小
宅	宀 乇
檡	木 睪
窄	穴 乍
鉙	金 只	釒 只
债	人 责	亻 责
砦	此 石
債	人 責	亻 責
寨	宀 一 共 木	宀 井 大 木
瘵	病 祭	疒 祭
枬	木 丹
沾	水 占	氵 占
毡	毛 占
旃	方 丿 一 円
栴	木 丿 一 円
粘	米 占
蛅	虫 占
蛅	蟲 占	虫 占
飦	食 干
惉	沾 心
詀	言 占	訁 占
趈	走 占
詹	刀 厂 儿 言
谵	言 詹	讠 詹
噡	口 詹
嶦	山 詹
薝	草 詹	艸 詹	艹 詹
邅	辵 亶	辶 亶
霑	雨 沾
氈	亶 毛
氊	毛 亶
瞻	目 詹
鹯	亶 鸟
旜	方 丿 一 亶
譫	言 詹	訁 詹
饘	食 亶
鳣	鱼 亶
驙	馬 亶
魙	鬼 漸
鱣	魚 亶
鸇	亶 鳥
讝	言 嚴	訁 嚴
斩	车 斤
飐	风 占
展	尸 龷 衣
盏	戋 皿
崭	山 斩
斬	車 斤
琖	玉 戔	王 戔
搌	手 展	扌 展	才 展
盞	戔 皿
嶃	山 斬
嶄	山 斬
榐	木 展
颭	風 占
嫸	女 善
醆	酉 戔
橏	木 善
輾	車 展
黵	黑 詹
占	卜 口
佔	人 占	亻 占
战	占 戈
栈	木 戋
桟	木 戈 二	木 戋 一
站	立 占
偡	人 甚	亻 甚
绽	丝 定	纟 定
菚	草 戔	艸 戔	艹 戔
棧	木 戔
湛	水 甚	氵 甚
戦	单 丶 戈
綻	絲 定	糹 定	糸 定
嶘	山 棧
輚	車 戔
戰	單 戈
虥	虎 戔
虦	戔 虎
覱	斬 見
轏	車 孱
譧	言 廉	訁 廉
蘸	草 酉 隹 火	艸 酉 隹 灬	艹 酉 隹 灬
驏	馬 孱
张	弓 长
張	弓 長
章	立 早
傽	人 章	亻 章
鄣	章 邑	章 阝
嫜	女 章
彰	章 彡
慞	心 章	忄 章
漳	水 章	氵 章
獐	犬 章	犭 章
粻	米 長
蔁	草 章	艸 章	艹 章
遧	辵 章	辶 章
暲	日 章
樟	木 章
璋	玉 章	王 章
餦	食 長
蟑	虫 章
蟑	蟲 章	虫 章
騿	馬 章
鱆	魚 章
麞	鹿 章
仉	人 几	亻 几
长	𠄌 一 丿 乁
涨	水 张	氵 张
掌	尚 口 手
漲	水 張	氵 張
礃	石 掌
丈	一 乂
仗	人 丈	亻 丈
扙	手 丈	扌 丈	才 丈
帐	巾 长
杖	木 丈
胀	肉 长	月 长
账	贝 长
帳	巾 長
涱	水 長	氵 長
脹	肉 長	月 長
痮	病 長	疒 長
障	阜 章	阝 章
墇	土 章
嶂	山 章
幛	巾 章
賬	貝 長
瘬	病 張	疒 張
瘴	病 章	疒 章
瞕	目 章
佋	人 召	亻 召
钊	金 刀	钅 刂
妱	女 召
巶	召 巳
招	手 召	扌 召	才 召
昭	日 召
盄	弔 皿
釗	金 刀	釒 刂
啁	口 周
鉊	金 召	釒 召
駋	馬 召
窼	穴 巢
鍣	金 苕	釒 苕
皽	亶 皮
爪	厂 丨 乀
爫	丿 小	丿 丶 丶 丶
找	手 戈	扌 戈	才 戈
沼	水 召	氵 召
瑵	玉 蚤	王 蚤
召	刀 口
兆	儿 丷 八	冰 儿 丶 丶	冫 儿 丶 丶
诏	言 召	讠 召
枛	木 爪
垗	土 兆
炤	火 召
狣	犬 兆	犭 兆
赵	走 乂
笊	竹 爪
肁	戶 聿
肁	户 聿
旐	方 丿 一 兆
棹	木 卓
詔	言 召	訁 召
照	日 召 火	日 召 灬
罩	网 卓	罒 卓	罓 卓
肇	戶 攴 聿	户 攴 聿	户 攵 聿	戸 攵 聿
肈	戶 戈 聿
肈	户 戈 聿
趙	走 肖
曌	明 空
燳	火 照
鮡	魚 兆
櫂	木 翟
瞾	目 目 空
羄	网 綽	罒 綽
蜇	折 虫
蜇	折 蟲	折 虫
嗻	口 庶
嫬	女 庶
遮	辵 庶	辶 庶
厇	厂 乇
折	手 斤	扌 斤	才 斤
歽	歹 斤
矺	石 乇
砓	石 殳
籷	米 乇
虴	虫 乇
虴	蟲 乇	虫 乇
哲	折 口
埑	折 土
粍	米 毛
袩	衣 占	衤 占
啠	斤 斤 口
悊	折 心
晢	折 日
晣	日 折
辄	车 耴
喆	吉 吉
蛰	执 虫
詟	龙 言
谪	言 啇	讠 啇
馲	馬 乇
摺	手 習	扌 習	才 習
輒	車 耴
磔	石 桀
輙	車 取
銸	金 耴	釒 耴
辙	车 彳 育 攵
蟄	執 蟲	執 虫
嚞	吉 吉 吉
謫	言 啇	訁 啇
謺	執 言
鮿	魚 耴
轍	車 彳 育 攵
讁	言 適	訁 適
讋	龍 言
者	土 丿 日	耂 日	老 日
啫	口 者
禇	示 者	礻 者
锗	钅 者
赭	赤 者
褶	衣 習	衤 習
襵	衣 聶	衤 聶
这	辵 文	辶 文
柘	木 石
浙	水 折	氵 折
這	辵 言	辶 言
淛	水 制	氵 制
蔗	草 庶	艸 庶	艹 庶
樜	木 庶
潪	水 智	氵 智
鹧	庶 鸟
蟅	虫 庶
蟅	蟲 庶	虫 庶
鷓	庶 鳥
着	羊 目
著	草 者	艸 者	艹 者
贞	卜 贝
针	金 十	钅 十
侦	人 贞	亻 贞
浈	水 贞	氵 贞
珍	玉 人 彡	王 人 彡
珎	玉 尓	王 尓
胗	肉 人 彡	月 人 彡
貞	卜 貝
帪	巾 辰
栕	木 臣
桢	木 贞
眞	匕 目 丨 一 八
真	十 目 一 八	直 八
砧	石 占
祯	示 贞	礻 贞
針	金 十	釒 十
偵	人 貞	亻 貞
桭	木 辰
酙	酉 斗
寊	宀 貞
葴	草 咸	艸 咸	艹 咸
遉	辵 貞	辶 貞
嫃	女 真
搸	手 秦	扌 秦	才 秦
斟	甚 斗
楨	木 貞
獉	犬 秦	犭 秦
甄	垔 瓦
禎	示 貞	礻 貞
蒖	草 真	艸 真	艹 真
蓁	草 秦	艸 秦	艹 秦
鉁	金 人 彡	釒 人 彡
靕	正 青
榛	木 秦
瑧	玉 秦	王 秦
碪	石 甚
禛	示 眞	礻 眞
潧	水 曾	氵 曾
箴	竹 咸
樼	木 孱
澵	水 新	氵 新
臻	至 秦
薽	草 甄	艸 甄	艹 甄
錱	金 王 王
轃	車 秦
鍼	金 咸	釒 咸
籈	竹 甄
鱵	魚 箴
诊	言 人 彡	讠 人 彡
抮	手 人 彡	扌 人 彡	才 人 彡
枕	木 冘
弫	弓 臣
昣	日 人 彡
轸	车 人 彡
屒	尸 辰
畛	田 人 彡
疹	病 人 彡	疒 人 彡
眕	目 人 彡
袗	衣 人 彡	衤 人 彡
紾	絲 人 彡	糹 人 彡	糸 人 彡
聄	耳 人 彡
裖	衣 辰	衤 辰
診	言 人 彡	訁 人 彡
軫	車 人 彡
缜	丝 真	纟 真
稹	禾 真
駗	馬 人 彡
縥	絲 秦	糹 秦	糸 秦
鬒	髟 真
黰	黑 真
圳	土 川
阵	阜 车	阝 车
纼	丝 引	纟 引
甽	田 川
侲	人 辰	亻 辰
挋	手 臣	扌 臣	才 臣
陣	阜 車	阝 車
鸩	冘 鸟
振	手 辰	扌 辰	才 辰
朕	肉 关	月 关
栚	木 关
紖	絲 引	糹 引	糸 引
眹	目 关
赈	贝 辰
酖	酉 冘
塦	陣 土
揕	手 甚	扌 甚	才 甚
絼	絲 豸	糹 豸	糸 豸
敶	陳 攴	陳 攵
瑱	玉 真	王 真
誫	言 辰	訁 辰
賑	貝 辰
镇	金 真	钅 真
震	雨 辰
鴆	冘 鳥
鎭	金 眞	釒 眞
鎮	金 真	釒 真
凧	几 巾
争	刀 聿	爫 彐 亅 爭	刀 彐 亅	刀 肀
佂	人 正	亻 正
姃	女 正
征	彳 正
怔	心 正	忄 正
爭	爪 聿	爫 肀
诤	言 争	讠 争
埩	土 爭
峥	山 争
挣	手 争	扌 争	才 争
炡	火 正
狰	犬 争	犭 争
烝	丞 火	丞 灬
眐	目 正
钲	金 正	钅 正
崝	山 青
崢	山 爭
掙	手 爭	扌 爭	才 爭
猙	犬 爭	犭 爭
睁	目 争
聇	耳 正
铮	金 争	钅 争
媜	女 貞
揁	手 貞	扌 貞	才 貞
筝	竹 争
徰	彳 正 正
蒸	草 烝	艸 烝	艹 烝
睜	目 爭
踭	足 爭
鉦	金 正	釒 正
徴	彳 山 王 攴	彳 山 王 攵
箏	竹 爭
錚	金 爭	釒 爭
篜	竹 烝
鬇	髟 争
鯖	魚 青
癥	病 徵	疒 徵
氶	了 乛 丶 乀
抍	手 升	扌 升	才 升
糽	絲 丁	糹 丁	糸 丁
拯	手 丞	扌 丞	才 丞
掟	手 定	扌 定	才 定
晸	日 政
愸	勑 心
撜	手 登	扌 登	才 登
整	敕 正	束 攵 正
正	一 止
证	言 正	讠 正
郑	关 邑	阝 邑
帧	巾 贞
政	正 攴	正 攵
症	病 正	疒 正
幀	巾 貞
証	言 正	訁 正
塣	浧 土
諍	言 爭	訁 爭
鄭	奠 邑	阝 邑
鴊	正 鳥
證	言 登	訁 登
之	丶 乛
支	十 又
卮	厂 一 卩
卮	厂 一 卩	厂 一 㔾
汁	水 十	氵 十
芝	草 之	艸 之	艹 之
吱	口 支
巵	厂 一 巴
汥	水 支	氵 支
坧	土 石
枝	木 支
泜	水 氐	氵 氐
知	矢 口
织	丝 只	纟 只
肢	肉 支	月 支
栀	木 卮
祗	示 氐	礻 氐
秓	禾 支
秖	禾 氏
胑	肉 只	月 只
胝	肉 氐	月 氐
衼	衣 支	衤 支
倁	人 知	亻 知
疷	病 氐	疒 氐
祬	示 至	礻 至
秪	禾 氐
脂	肉 旨	月 旨
隻	隹 又
梔	木 巵
戠	音 戈
椥	木 知
臸	至 至
搘	手 耆	扌 耆	才 耆
禔	示 是	礻 是
稙	禾 直
綕	絲 志	糹 志	糸 志
榰	木 耆
蜘	虫 知
蜘	蟲 知	虫 知
馶	馬 支
鳷	支 鳥
鴲	旨 鳥
織	絲 戠	糹 戠	糸 戠
蘵	草 職	艸 職	艹 職
鼅	知 黽
执	手 丸	扌 丸	才 丸
侄	人 至	亻 至
妷	女 失
直	十 目 丨 一
姪	女 至
値	人 直	亻 直
值	人 直	亻 直
聀	耳 戈
釞	金 入	釒 入
埴	土 直
執	幸 丸
淔	水 直	氵 直
职	耳 只
植	木 直
殖	歹 直
犆	牛 直	牜 直
禃	示 直	礻 直
絷	执 糸
跖	足 石
瓡	幸 瓜
鉄	金 失	釒 失
墌	土 庶
摭	手 庶	扌 庶	才 庶
馽	馬 中
嬂	女 戠
慹	執 心
漐	執 水
踯	足 郑
樴	木 戠
膱	肉 戠	月 戠
縶	執 糸
職	耳 戠
蟙	蟲 戠	虫 戠
蹠	足 庶
軄	身 戠
躑	足 鄭
夂	丿 丿 乀
止	上 丨
只	口 八
劧	手 力
旨	匕 日
阯	阜 止	阝 止
址	土 止
坁	土 氏
帋	氏 巾
扺	手 氏	扌 氏	才 氏
汦	水 氏	氵 氏
沚	水 止	氵 止
纸	丝 氏	纟 氏
芷	草 止	艸 止	艹 止
抧	手 只	扌 只	才 只
祉	示 止	礻 止
茋	草 氐	艸 氐	艹 氐
咫	尺 只
恉	心 旨	忄 旨
指	手 旨	扌 旨	才 旨
枳	木 只
洔	水 寺	氵 寺
砋	石 止
衹	衣 氏	衤 氏
轵	车 只
淽	水 芷	氵 芷
疻	病 只	疒 只
紙	絲 氏	糹 氏	糸 氏
訨	言 止	訁 止
趾	足 止
軹	車 只
黹	业 八 巾 八
酯	酉 旨
徵	彳 山 一 王 攴	彳 山 一 王 攵
藢	草 徵	艸 徵	艹 徵
襧	衣 爾	衤 爾
阤	阜 也	阝 也
至	一 厶 土
芖	草 大	艸 大	艹 大
志	士 心
忮	心 支	忄 支
扻	手 欠	扌 欠	才 欠
豸	丿 丶 丶 丿 亅 丿 丿
制	丿 二 巾 刀	丿 二 巾 刂
厔	厂 至
垁	土 矢
帙	巾 失
帜	巾 只
治	水 台	氵 台
炙	肉 火	月 火
质	厂 十 贝
迣	辵 世	辶 世
郅	至 邑	至 阝
峙	山 寺
庢	广 至
庤	广 寺
挃	手 至	扌 至	才 至
柣	木 失
栉	木 节
洷	水 至	氵 至
祑	示 失	礻 失
陟	阜 步	阝 步
娡	女 志
徏	彳 步
挚	执 手
晊	日 至
桎	木 至
狾	犬 折	犭 折
秩	禾 失
致	至 攴
致	至 攴	至 攵
袟	衣 失	衤 失
贽	执 贝
轾	车 至
乿	爪 糸 乙	爫 糸 乚
偫	人 待	亻 待
徝	彳 直
掷	手 郑	扌 郑	才 郑
梽	木 志
楖	木 即
猘	犬 制	犭 制
畤	田 寺
痔	病 寺	疒 寺
秲	禾 寺
秷	禾 至
窒	穴 至
紩	絲 失	糹 失	糸 失
翐	羽 失
袠	衣 失
觗	角 氏
貭	盾 八	厂 十 貝	厂 真
铚	金 至	钅 至
鸷	执 鸟
傂	人 虒	亻 虒
崻	山 待
彘	彑 比 矢	彑 匕 矢 匕
智	知 日
滞	水 带	氵 带
痣	病 志	疒 志
蛭	虫 至
蛭	蟲 至	虫 至
軽	車 圣
骘	陟 马
寘	宀 真
廌	广 乛 一 丨 丨 乛 火	广 乛 一 丨 丨 乛 灬
搱	手 屖	扌 屖	才 屖
滍	水 蚩	氵 蚩
稚	禾 隹
筫	竹 貝
置	网 直	罒 直	罓 直
跱	足 寺
輊	車 至
锧	金 质	钅 质
雉	矢 隹
墆	土 帶
滯	水 帶	氵 帶
潌	水 窒	氵 窒
疐	十 冖 田 疋
製	制 衣
覟	志 見
誌	言 志	訁 志
銍	金 至	釒 至
幟	巾 戠
憄	徝 心
摯	執 手
熫	火 庶
稺	禾 屖
膣	肉 窒	月 窒
觯	角 单
質	斤 斤 貝
踬	足 质
鋕	金 志	釒 志
擳	手 節	扌 節	才 節
旘	方 丿 一 戠
瀄	水 節	氵 節
緻	絲 致	糹 致	糸 致
隲	阜 少 馬	阝 少 馬
駤	馬 至
鴙	矢 鳥
儨	人 質	亻 質
劕	質 刀	質 刂
懥	心 疐	忄 疐
擲	手 鄭	扌 鄭	才 鄭
櫛	木 節
穉	禾 犀
螲	虫 窒
螲	蟲 窒	虫 窒
懫	心 質	忄 質
贄	執 貝
櫍	木 質
瓆	玉 質	王 質
觶	角 單
騭	陟 馬
鯯	魚 制
礩	石 質
豑	豊 弟
騺	執 馬
驇	埶 馬
躓	足 質
鷙	執 鳥
鑕	金 質	釒 質
豒	豐 弟
中	口 丨
伀	人 公	亻 公
汷	水 攴	氵 攵
刣	台 刀	台 刂
妐	女 公
彸	彳 公
忠	中 心
泈	水 冬	氵 冬
炂	火 公
终	丝 冬	纟 冬
柊	木 冬
盅	中 皿
衳	衣 公	衤 公
钟	金 中	钅 中
舯	舟 中
衷	衣 中	亠 中 衣
衷	衣 中	一 中 衣
終	絲 冬	糹 冬	糸 冬
鈡	金 中	釒 中
幒	巾 悤
蔠	草 終	艸 終	艹 終
锺	金 重	钅 重
銿	金 甬	釒 甬
螤	蚉 臾
鴤	鳥 冬
螽	冬 虫 虫
螽	冬 蟲 蟲	冬 虫 虫
鍾	金 重	釒 重
鼨	鼠 冬
蹱	足 童
鐘	金 童	釒 童
籦	竹 鍾
肿	肉 中	月 中
种	禾 中
冢	冖 豖
喠	口 重
尰	尢 重
塚	土 冢
塜	土 冡
歱	止 重
煄	火 重
腫	肉 重	月 重
瘇	病 重	疒 重
種	禾 重
踵	足 重
穜	禾 童
仲	人 中	亻 中
众	人 人 人
妕	女 中
狆	犬 中	犭 中
祌	示 中	礻 中
茽	草 仲	艸 仲	艹 仲
衶	衣 中	衤 中
重	丿 一 里
蚛	虫 中
蚛	蟲 中	虫 中
偅	人 重	亻 重
眾	网 丿 丨 人 人	罒 丿 丨 人 人	罓 丿 丨 人 人
堹	土 重
媑	女 重
筗	竹 仲
衆	血 乑
諥	言 重	訁 重
州	川 丶 丶 丶
舟	丶 冂 一 丶 丶	丶 冂 一 丶 丨
诌	言 刍	讠 刍
侜	人 舟	亻 舟
周	冂 土 口
洲	水 州	氵 州
诪	言 寿	讠 寿
烐	火 舟
珘	玉 舟	王 舟
辀	车 舟
徟	彳 周
掫	手 取	扌 取	才 取
淍	水 周	氵 周
矪	矢 舟
週	辵 周	辶 周
鸼	舟 鸟
喌	口 口 州
粥	弓 米 弓
赒	贝 周
輈	車 舟
銂	金 州	釒 州
賙	貝 周
輖	車 周
霌	雨 周
盩	幸 攵 皿
謅	言 芻	訁 芻
鵃	舟 鳥
騆	馬 周
譸	言 壽	訁 壽
妯	女 由
轴	车 由
軸	車 由
肘	肉 寸	月 寸
帚	彐 冖 巾
疛	病 寸	疒 寸
菷	草 帚	艸 帚	艹 帚
晭	日 周
睭	目 周
箒	竹 帚
鯞	魚 帚
纣	丝 寸	纟 寸
伷	人 由	亻 由
呪	口 兄
咒	口 口 几
宙	宀 由
绉	丝 刍	纟 刍
冑	由 冃	由 冂 二	由 月
咮	口 朱
昼	尺 旦
紂	絲 寸	糹 寸	糸 寸
胄	由 肉	由 月
荮	草 纣	艸 纣	艹 纣
皱	刍 皮
酎	酉 寸
晝	聿 旦
粙	米 由
葤	草 紂	艸 紂	艹 紂
詋	言 兄	訁 兄
甃	秋 瓦
詶	言 州	訁 州
僽	人 愁	亻 愁
皺	芻 皮
駎	馬 由
噣	口 蜀
縐	絲 芻	糹 芻	糸 芻
骤	马 聚
籀	竹 手 留	竹 扌 留
籕	竹 榴
籒	竹 手 畱	竹 扌 畱	竹 才 畱
驟	馬 聚
朱	丿 未	丶 未	丿 一 木 未
劯	石 力
侏	人 朱	亻 朱
诛	言 朱	讠 朱
邾	朱 邑	朱 阝
洙	水 朱	氵 朱
茱	草 朱	艸 朱	艹 朱
株	木 朱
珠	玉 朱	王 朱
诸	言 者	讠 者
猪	犬 者	犭 者
硃	石 朱
秼	禾 朱
袾	衣 朱	衤 朱
铢	金 朱	钅 朱
絑	絲 朱	糹 朱	糸 朱
蛛	虫 朱
蛛	蟲 朱	虫 朱
誅	言 朱	訁 朱
跦	足 朱
槠	木 诸
潴	水 猪	氵 猪
蝫	虫 者
蝫	蟲 者	虫 者
銖	金 朱	釒 朱
橥	木 猪
諸	言 者	訁 者
豬	豕 者
鮢	魚 朱
鴸	朱 鳥
瀦	水 豬	氵 豬
櫫	木 豬
櫧	木 諸
鯺	魚 者
鼄	朱 黽
蠩	蟲 諸	虫 諸
竹	丿 一 丨 丿 一 亅
泏	水 出	氵 出
竺	竹 二
炢	火 术
笁	竹 工
茿	草 巩	艸 巩	艹 巩
烛	火 虫
窋	穴 出
逐	辵 豕	辶 豕
笜	竹 出
舳	舟 由
瘃	病 豖	疒 豖
築	筑 木	竹 巩 木	竹 工 凡 木
燭	火 蜀
蠋	虫 蜀
蠋	蟲 蜀	虫 蜀
躅	足 蜀
鱁	魚 逐
孎	女 屬
灟	水 屬	氵 屬
曯	日 屬
欘	木 屬
爥	火 屬
蠾	虫 尸 水 蜀
蠾	蟲 屬	虫 屬
钃	金 屬	釒 屬
主	丶 王
宔	宀 主
拄	手 主	扌 主	才 主
罜	网 主	罒 主
陼	阜 者	阝 者
渚	水 者	氵 者
煮	者 火	者 灬
煑	者 火
詝	言 宁	訁 宁
嘱	口 属
濐	水 暑	氵 暑
麈	鹿 主
瞩	目 属
劚	屬 刀	屬 刂
囑	口 屬
斸	屬 斤
矚	目 屬
伫	人 宀 一	亻 宀 一
佇	人 宁	亻 宁
佇	亻 宀 丁	人 宁
住	人 主	亻 主
助	且 力
纻	丝 宀 一	纟 宀 一
苎	草 宀 一	艸 宀 一	艹 宀 一
坾	土 宁
杼	木 予
注	水 主	氵 主
贮	贝 宀 一
迬	辵 主	辶 主
驻	马 主
壴	十 豆	士 口 丷 一
柱	木 主
殶	主 殳
炷	火 主
祝	示 兄	礻 兄
疰	病 主	疒 主
眝	目 宁
砫	石 主
祩	示 朱	礻 朱
竚	立 宁
莇	草 助	艸 助	艹 助
紵	絲 宁	糹 宁	糸 宁
紸	絲 主	糹 主	糸 主
羜	羊 宁
蛀	虫 主
蛀	蟲 主	虫 主
嵀	山 柱
筑	竹 巩
註	言 主	訁 主
貯	貝 宁
跓	足 主
軴	車 主
铸	金 寿	钅 寿
筯	竹 助
鉒	金 主	釒 主
馵	馬 廾
箸	竹 者
翥	者 羽
樦	木 竹 主
鋳	金 寿	釒 寿
駐	馬 主
篫	筑 手	竹 巩 手
霔	雨 注
麆	鹿 且
鑄	金 壽	釒 壽
抓	手 爪	扌 爪	才 爪
檛	木 過
膼	肉 過	月 過
簻	竹 過
髽	髟 坐
拽	手 曳	扌 曳	才 曳
跩	足 曳
专	二 丨 龴
叀	一 由 厶
専	一 由 寸
砖	石 专
專	叀 寸	一 由 厶 寸
鄟	專 邑	專 阝
塼	土 專
嫥	女 專
瑼	玉 專	王 專
甎	專 瓦
膞	肉 專	月 專
颛	耑 页
磚	石 專
諯	言 耑	訁 耑
蟤	虫 巽
蟤	蟲 巽	虫 巽
顓	耑 頁
鱄	魚 專
转	车 专
孨	子 子 子
転	車 云
竱	立 專
轉	車 專
灷	火 廾
啭	口 转
堟	土 彖
蒃	草 彖	艸 彖	艹 彖
瑑	玉 彖	王 彖
腞	肉 彖	月 彖
僎	人 巽	亻 巽
赚	贝 兼
撰	手 巽	扌 巽	才 巽
篆	竹 彖
馔	食 巽	饣 巽
篹	竹 目 大 卩	竹 目 大 㔾
襈	衣 巽	衤 巽
賺	貝 兼
譔	言 巽	訁 巽
饌	食 巽	飠 巽
囀	口 轉
籑	竹 目 一 食	竹 目 大 良
妆	丬 女
庄	广 土
妝	爿 女
荘	草 壮	艸 壮	艹 壮
娤	壯 女
桩	木 庄
莊	草 壯	艸 壯	艹 壯
梉	木 壯
湷	水 春	氵 春
粧	米 庄
装	壮 衣
裝	壯 衣
樁	木 舂
糚	米 莊
壮	丬 士
壯	爿 士
状	丬 犬
狀	爿 犬
壵	士 士 士
焋	壯 火	壯 灬
漴	水 崇	氵 崇
撞	手 童	扌 童	才 童
戇	立 早 攴 頁 心	立 早 攵 頁 心
隹	人 主 一
追	辵 戶 乛 一	辶 戶 乛 一	辵 户 乛 一	辶 户 乛 一
骓	马 隹
锥	金 隹	钅 隹
錐	金 隹	釒 隹
騅	馬 隹
鵻	鳥 隹
沝	水 水
坠	队 土
桘	木 戶 乛 一	木 户 乛 一
笍	竹 內
笍	竹 内
娷	女 垂
缀	丝 叕	纟 叕
惴	心 耑	忄 耑	心 山 而	忄 山 而
甀	垂 瓦
缒	丝 追	纟 追
畷	田 叕
硾	石 垂
膇	肉 追	月 追
墜	隊 土
綴	絲 叕	糹 叕	糸 叕
赘	敖 贝
縋	絲 追	糹 追	糸 追
諈	言 垂	訁 垂
醊	酉 叕
錣	金 叕	釒 叕
餟	食 叕
礈	石 遂
贅	敖 貝
轛	車 對
鑆	金 對	釒 對
宒	宀 毛
迍	辵 屯	辶 屯
肫	肉 屯	月 屯
窀	穴 屯
谆	言 享	讠 享
諄	言 享	訁 享
衠	行 真	彳 真 亍
准	冰 隹	冫 隹
埻	土 享
準	水 隹 十	氵 隹 十
綧	絲 享	糹 享	糸 享
訰	言 屯	訁 屯
稕	禾 享
卓	卜 日 十
拙	手 出	扌 出	才 出
炪	火 出
倬	人 卓	亻 卓
捉	手 足	扌 足	才 足
桌	木 卜 日
棁	木 兑
涿	水 豖	氵 豖
棳	木 叕
槕	木 卓
穛	禾 焦
穱	禾 爵
蠿	幺 幺 一 丨 一 幺 幺 虫 虫
蠿	幺 幺 一 丨 一 幺 幺 蟲 蟲	幺 幺 一 丨 一 幺 幺 虫 虫
圴	土 勺
彴	彳 勺
汋	水 勺	氵 勺
犳	犬 勺	犭 勺
灼	火 勺
叕	又 又 又 又
叕	又 又 又 又	双 双
妰	女 乍
茁	草 出	艸 出	艹 出
斫	石 斤
浊	水 虫	氵 虫
丵	业 丷 干
浞	水 足	氵 足
烵	火 勺
诼	言 豖	讠 豖
酌	酉 勺
啄	口 豖
啅	口 卓
娺	女 叕
梲	木 兌
斱	者 斤
晫	日 卓
椓	木 豖
琸	玉 卓	王 卓
硺	石 豖
窡	穴 叕
罬	网 叕	罒 叕
撯	手 着	扌 着
擆	手 著	扌 著	才 著
禚	示 羔	礻 羔
劅	蜀 刀	蜀 刂
諁	言 叕	訁 叕
諑	言 豖	訁 豖
鋜	金 足	釒 足
濁	水 蜀	氵 蜀
篧	竹 隺
擢	手 翟	扌 翟	才 翟
斀	蜀 攴
斵	卯 亞 斤
濯	水 翟	氵 翟
櫡	木 箸
謶	言 庶	訁 庶
镯	金 蜀	钅 蜀
鐯	金 著	釒 著
鵫	卓 鳥
灂	水 爵	氵 爵
蠗	虫 翟
蠗	蟲 翟	虫 翟
鐲	金 蜀	釒 蜀
籗	竹 霍
鷟	族 鳥
籱	竹 雨 雔	竹 雨 隹 隹
孜	子 攴	子 攵
茊	草 丘	艸 丘	艹 丘
兹	丷 一 幺 幺
咨	次 口
姕	此 女
姿	次 女
茲	草 幺 幺	艸 幺 幺	艹 幺 幺
栥	次 木
玆	玄 玄
紎	絲 犬	糹 犬	糸 犬
赀	此 贝
资	次 贝
淄	水 甾	氵 甾
秶	次 禾
缁	丝 甾	纟 甾
谘	言 咨	讠 咨
赼	走 欠
嗞	口 兹
孳	兹 子
嵫	山 兹
椔	木 甾
湽	水 甾 一	氵 甾 一
滋	水 兹	氵 兹
粢	次 米
葘	草 甾 一	艸 甾 一	艹 甾 一
辎	车 甾
鄑	晉 邑	晉 阝
孶	茲 子
禌	示 兹	礻 兹
觜	此 角
訾	此 言
貲	此 貝
資	次 貝
趑	走 次
锱	金 甾	钅 甾
稵	禾 兹
緇	絲 甾	糹 甾	糸 甾
鈭	此 金
镃	金 兹	钅 兹
龇	齿 此
輜	車 甾
鼒	才 鼎
澬	水 資	氵 資
諮	言 咨	訁 咨
趦	走 咨
輺	車 甾 一
錙	金 甾	釒 甾
髭	髟 此
鲻	鱼 甾
鍿	金 甾 一	釒 甾 一
鎡	金 兹	釒 兹
璾	玉 齊	王 齊
頿	彡 此 頁	須 此
頾	須 此
鯔	魚 甾
鶅	甾 鳥
齍	齊 皿
蓻	草 執	艸 執	艹 執
仔	人 子	亻 子
吇	口 子
姉	女 市
姊	女 丿 乛 丨 丿
姊	女 丿 乛 丨 丿	女 𠂔
杍	木 子
矷	石 子
秄	禾 子
胏	肉 丿 乛 丨 丿	月 丿 乛 丨 丿	肉 𠂔	月 𠂔
呰	此 口
秭	禾 丿 乛 丨 丿
秭	禾 丿 乛 丨 丿	禾 𠂔
籽	米 子
耔	耒 子
虸	虫 子
虸	蟲 子	虫 子
笫	竹 丿 乛 丨 丿
笫	竹 丿 乛 丨 丿	竹 𠂔
梓	木 辛
釨	金 子	釒 子
啙	此 口 口
紫	此 丝	此 糸
紫	此 絲	此 糸
滓	水 宰	氵 宰
訿	言 此	訁 此
榟	木 宰
字	宀 子
自	丶 目
芓	草 子	艸 子	艹 子
茡	草 字	艸 字	艹 字
倳	人 事	亻 事
剚	事 刀	事 刂
恣	次 心
牸	牛 字	牜 字
渍	水 责	氵 责
眥	此 目
眦	目 此
胔	此 肉	此 月
胾	十 戈 肉	土 戈 肉	𢦏 肉
漬	水 責	氵 責
子	了 一
宗	宀 示
倧	人 宗	亻 宗
综	丝 宗	纟 宗
骔	马 宗
堫	土 凶 八 夕	土 凶 八 夂
嵏	山 凶 八 夕	山 凶 八 夂
嵕	山 凶 八 夕	山 凶 八 夂
惾	心 凶 八 夕	忄 凶 八 夂
棕	木 宗
猣	犬 凶 八 夕	犭 凶 八 夕	犬 凶 八 夂	犭 凶 八 夂
腙	肉 宗	月 宗
葼	草 凶 八 夕	艸 凶 八 夂	艹 凶 八 夂
椶	木 凶 八 夕	木 凶 八 夂
朡	月 凶 八 夕	月 凶 八 夂
嵸	山 從
稯	禾 凶 八 夕	禾 凶 八 夂
綜	絲 宗	糹 宗	糸 宗
緃	絲 從	糹 從	糸 從
熧	從 火
緵	絲 凶 八 夕	糹 凶 八 夕	糸 凶 八 夕	絲 凶 八 夂	糹 凶 八 夂	糸 凶 八 夂
翪	羽 凶 八 夕	羽 凶 八 夂
蝬	虫 凶 八 夕	虫 凶 八 夂
蝬	蟲 凶 八 夕	虫 凶 八 夂
踨	足 從
踪	足 宗
磫	石 從
鍐	金 凶 儿 夕	釒 凶 儿 夂
豵	豕 從
蹤	足 從
騌	馬 宗
鬃	髟 宗
騣	馬 凶 八 夕	馬 凶 八 夂
鬉	髟 凶 八 夕	髟 凶 八 夂
鬷	鬲 凶 八 夕	鬲 凶 八 夂
鯮	魚 宗
鯼	魚 凶 八 夕	魚 凶 八 夂
鑁	金 囟 丶 丶 丶 丶 儿 夕	釒 囟 丶 丶 丶 丶 儿 夂
总	丷 口 心
偬	人 怱	亻 怱
捴	手 忩	扌 忩	才 忩
惣	物 心
愡	心 怱	忄 怱
揔	手 怱	扌 怱	才 怱
搃	手 总	扌 总
傯	人 悤	亻 悤
蓗	草 徒	艸 徒	艹 徒
摠	手 悤	扌 悤	才 悤
総	絲 忩	糹 忩	糸 忩
縂	絲 总	糹 总	糸 总
燪	火 葱
總	絲 悤	糹 悤	糸 悤	糸 囱 心
鏓	金 悤	釒 悤
纵	丝 从	纟 从
昮	日 功
疭	病 从	疒 从
倊	人 忩	亻 忩
猔	犬 宗	犭 宗
碂	石 宗
粽	米 宗
糉	米 凶 八 夕	米 凶 八 夂
瘲	病 從	疒 從
縦	絲 従	糹 従	糸 従
錝	金 宗	釒 宗
縱	絲 從	糹 從	糸 從
邹	刍 邑	刍 阝
驺	马 刍
诹	言 取	讠 取
郰	取 邑	取 阝
陬	阜 取	阝 取
菆	草 取	艸 取	艹 取
棷	木 取
棸	取 木
鄒	芻 邑	芻 阝
箃	竹 取
緅	絲 取	糹 取	糸 取
諏	言 取	訁 取
鄹	聚 邑	聚 阝
鲰	鱼 取
鯫	魚 取
黀	麻 取
騶	馬 芻
齱	齒 取
齺	齒 芻
赱	土 丷 人
走	十 疋
奏	手 乀 夭	𡗗 夭
揍	手 奏	扌 奏	才 奏
楱	木 奏
租	禾 且
葅	草 俎	艸 俎	艹 俎
蒩	草 租	艸 租	艹 租
卆	九 十
足	口 卜 人
卒	亠 人 十
哫	口 足
崒	山 卒
崪	山 卒
族	方 丿 一 矢
傶	人 戚	亻 戚
箤	竹 卒
踤	足 卒
踿	足 秋
镞	金 族	钅 族
鏃	金 族	釒 族
诅	言 且	讠 且
阻	阜 且	阝 且
组	丝 且	纟 且
俎	人 人 且	仌 且
爼	爻 且
珇	玉 且	王 且
祖	示 且	礻 且
唨	口 阻
組	絲 且	糹 且	糸 且
詛	言 且	訁 且
靻	革 且
钻	金 占	钅 占
躜	足 赞
鑽	金 贊	釒 贊
繤	苜 大 糸
缵	丝 赞	纟 赞
纂	竹 目 大 絲	竹 目 大 糸	竹 目 大 丝
纉	絲 賛	糹 賛	糸 賛
籫	竹 贊
纘	絲 贊	糹 贊	糸 贊
攥	手 纂	扌 纂	才 纂
鑚	金 賛	釒 賛
厜	厂 垂
朘	月 夋
嗺	口 崔
樶	木 最
蟕	虫 觜
蟕	蟲 觜	虫 觜
纗	絲 巂	糹 巂	糸 巂
嶊	山 推
嘴	口 觜
嶵	山 罪
噿	口 翠
璻	玉 翠	王 翠
栬	木 色
絊	絲 本	糹 本	糸 本
酔	酉 卆
最	曰 取	日 取
晬	日 卒
祽	示 卒	礻 卒
稡	禾 卒
罪	网 非	罒 非	罓 非
辠	自 辛
槜	木 隽
酻	酉 孚
蕞	草 最	艸 最	艹 最
醉	酉 卒
檇	木 雋
鋷	金 取	釒 取
錊	金 卒	釒 卒
檌	木 罪
尊	酋 寸
墫	土 尊
壿	土 尊
嶟	山 尊
遵	辵 尊	辶 尊
樽	木 尊
繜	絲 尊	糹 尊	糸 尊
罇	缶 尊
鐏	金 尊	釒 尊
鳟	鱼 尊
鱒	魚 尊
鷷	尊 鳥
僔	人 尊	亻 尊
噂	口 尊
撙	手 尊	扌 尊	才 尊
譐	言 尊	訁 尊
捘	手 夋	扌 夋	才 夋
銌	金 存	釒 存
昨	日 乍
秨	禾 乍
莋	草 作	艸 作	艹 作
捽	手 卒	扌 卒	才 卒
椊	木 卒
琢	玉 豖	王 豖
稓	禾 昔
筰	竹 作
鈼	金 乍	釒 乍
左	一 丿 工
佐	人 左	亻 左
繓	絲 最	糹 最	糸 最
作	人 乍	亻 乍
坐	人 人 土	从 土
阼	阜 乍	阝 乍
岝	山 乍
岞	山 乍
怍	心 乍	忄 乍
侳	人 坐	亻 坐
祚	示 乍	礻 乍
胙	肉 乍	月 乍
唑	口 坐
座	广 坐
袏	衣 左	衤 左
做	人 故	亻 故
葃	草 昨	艸 昨	艹 昨
葄	草 胙	艸 胙	艹 胙
飵	食 乍
糳	丵 臼 殳 米
咗	口 左
鿍	土 夅
鿎	石 达
鿏	钅 麦
鿕	鱼 丹
㐨	予 予
㐩	井 井
㐽	人 风	亻 风
㑇	人 刍
㑈	人 东	亻 东
㑊	人 亦
㑩	人 罗	亻 罗
㒓	人 達	亻 達
㒭	兄 兄
㒹	真 真
㓟	皮 刀	皮 刂
㓤	吉 刀	吉 刂
㓥	当 刀	当 刂
㔉	属 刀	属 刂
㕕	厶 厶
㕛	又 又
㕭	口 夭
㕮	口 父
㕸	口 立
㖊	口 寻
㖞	口 呙	口 口 内
㖠	口 奈
㖭	口 添
㗅	口 胡
㗆	口 革
㗎	口 架
㗾	口 靴
㘎	口 门 敢	口 阚
㘘	絲 言 口	糸 言 糸 口	䜌 口
㙍	土 叕
㙘	土 要
㙦	斜 土
㚇	兇 夂	凶 八 夂	凶 八 夕
㚐	大 大
㚘	夫 夫
㚡	奇 奇
㚣	女 女
㛀	女 刍	女 刀 山
㛃	丰 刀 女
㛚	女 甬
㛤	女 丽
㛹	女 便
㝇	享 享
㞗	尸 求
㟃	山 司
㠇	山 就
㠓	山 蒙
㤘	忄 刍	
㤻	卵 心
㥄	忄 夌
㥪	心 娄	忄 娄
㦴	各 戈
㧐	手 双
㧑	手 为
㧟	手 汇
㧬	巩 手
㧵	手 否	扌 否	才 否
㧹	手 得	扌 得	才 得
㧺	手 沓	扌 沓	才 沓
㧻	手 豖	扌 豖	才 豖
㧼	手 表	扌 表	才 表
㧽	手 固	扌 固	才 固
㧾	手 忽	扌 忽	才 忽
㧿	手 從	扌 從	才 從
㨀	手 秉	扌 秉	才 秉
㨁	手 直	扌 直	才 直
㨃	手 享	扌 享	才 享
㨄	手 周	扌 周	才 周
㨅	手 芮	扌 芮	才 芮
㨆	手 林	扌 林	才 林
㨇	波 手
㨈	手 斉	扌 斉	才 斉
㨉	手 昬	扌 昬	才 昬
㨊	手 左 肉	扌 左 肉	才 左 肉
㨋	手 者	扌 者	才 者
㨌	士 冖 手 殳
㨍	封 手
㨎	手 耎	扌 耎	才 耎
㨏	手 炭	扌 炭	才 炭
㨐	手 保	扌 保	才 保
㨑	手 㚇	扌 㚇	才 㚇
㨒	手 奎	扌 奎	才 奎
㨓	手 罕	扌 罕	才 罕
㨔	手 咸	扌 咸	才 咸
㨕	手 盈	扌 盈	才 盈
㨗	手 疌	扌 疌	才 疌
㨘	手 省	扌 省	才 省
㨢	手 能	扌 能	才 能
㨥	手 納	扌 納	才 納
㩒	手 禁	扌 禁	才 禁
㩧	手 暴	扌 暴	才 暴
㩻	危 支
㫰	日 良
㬊	日 爱
㬎	日 四 灬
㬚	日 彳 育 攵
㭎	木 冈
㭏	木 韦
㭕	木 去
㮾	朗 木
㯤	来 来
㯥	东 东
㰀	木 黎
㱦	歹 奇
㱩	歹 卖
㱮	歹 贵
㲎	毛 毛
㲿	水 广	氵 广
㳇	氵 父
㳕	水 兰	氵 兰
㳘	氵 充
㳚	氵 戍
㳠	水 达	氵 达
㴋	水 肃	氵 肃
㴔	氵 急
㵐	氵 厥
㶲	火 用
㶽	火 呙	火 口 内
㷰	火 离
㸆	火 靠
㸌	火 霍
㸞	片 片
㹃	非 牛
㹜	犬 犬
㺄	犬 俞
㻬	王 雩	玉 雩
㼌	瓜 瓜
㽏	洽 甘	氵 合 甘
㽬	畐 畐
㿟	白 白
㿠	白 光
㿭	斥 皮
䀹	目 夾
䁓	目 㚇
䁓	目 㚇	目 凶 八 夂	目 兇 夂
䁖	目 娄
䁪	目 斬
䂮	丰 刀 石
䂿	石 沓
䃅	石 单
䃎	石 大 多	石 奓
䅟	禾 参
䇱	竹 囗 夕
䈫	竹 納
䉤	竹 数
䉭	竹 巤
䉺	米 工
䌹	纟 冋	纟 冂 口
䍇	缶 乏
䎃	冉 羽
䎖	曾 羽
䎜	老 老
䏝	月 专	肉 专
䏡	月 示	肉 示
䏲	月 弟
䐃	月 囷	月 口 禾
䐙	肉 革	月 革
䓕	草 远	艸 远	艹 远
䓖	艹 穷	艹 冖 八 力
䓛	艹 屈
䓨	艹 冖 缶
䓫	艹 奇
䓬	艹 卓
䖙	卧 虒
䖙	卧 虒	臥 虒
䖵	虫 虫
䗖	虫 带
䗛	虫 脩	虫 攸 月	虫 攸 肉
䗪	广 廿 灬 虫	庶 虫
䗴	虫 竹 廷
䘆	蟲 憲	虫 憲
䛿	言 鬲
䜣	讠 斤
䜥	讠 廴 旦	
䜩	言 燕	讠 燕
䝙	豸 区
䞘	走 乞
䟜	足 內
䟴	足 辰
䠋	足 卑
䡛	車 車
䢂	车 立
䢺	出 阝
䢼	共 阝
䣈	邑 邑
䣘	堂 阝
䤚	月 里
䥽	钅 发
䦃	钅 著
䨇	隻 隻
䨣	雨 革
䨩	雨 神
䪂	革 棘
䪭	音 音
䫯	旑 頁
䬕	風 風
䭔	食 追	飠 追
䭮	髟 首
䭰	香 奉
䱀	魚 央
䲆	魚 魚
䲞	鱼 立
䲟	鱼 印
䲠	鱼 春
䲡	鱼 酋
䲢	月 𠔉 鱼	肉 𠔉 鱼
䳍	共 鳥
䴓	一 巾 鸟	
䴔	交 鸟
䴕	列 鸟
䴖	青 鸟
䴗	目 犬 鸟
䴘	厂 虎 鸟
䴙	辟 鸟
䶮	龙 天
𠀘	兀 兀
𠁷	串 串
𠃄	𠂢 𠂢
𠃏	乚 乚
𠃐	乙 乙
𠃙	九 九
𠃧	飞 飞
𠅤	亠 思
𠅯	亦 亦
𠆲	人 广	亻 广
𠇹	人 𢀖	亻 𢀖
𠈙	人 戋	亻 戋	人 戈 一
𠊟	人 黾	亻 黾
𠋆	人 亲	亻 亲
𠎳	余 余
𠐇	来 来
𠑐	倉 倉
𠑲	僉 僉
𠓜	入 入
𠔁	八 八
𠘬	几 几
𠘻	凡 凡
𠙶	凵 了
𠛅	区 刀	区 刂
𠜱	卑 刀	卑 刂
𠝹	界 刀	界 刂
𠠴	力 力
𠡠	来 力
𠣪	句 句
𠥺	區 區
𠮨	口 乃
𠮶	口 个
𠯏	口 气
𠯟	口 见
𠯠	口 为
𠰷	口 卢
𠱃	口 凹
𠱸	口 臣
𠲔	囗 亦
𠲝	口 对
𠳐	口 邦
𠳬	古 古
𠳯	号 号
𠴕	口 妙
𠵼	口 孟
𠵿	口 披
𠶧	口 店
𠸎	口 挐
𠹳	口 桀
𠺘	口 浪
𠺝	口 格
𠺪	口 氣
𠺫	口 料
𠻗	口 离
𠻹	口 添
𠼮	口 僞
𠼱	口 累
𠼻	口 基
𠽤	口 戟
𠾍	口 棄
𠾴	口 棒
𠿭	口 滑
𡀔	口 路
𡁜	口 禍
𡁯	口 奪
𡁵	口 緊
𡁶	口 截
𡁻	口 趙
𡃁	口 靚
𡃴	口 隨
𡃶	口 錫
𡄽	口 瀉
𡆃	善 善
𡉼	升 土
𡍚	土 林
𡎚	土 扁
𡐓	土 康
𡒄	土 禀
𡔯	吉 吉
𡕩	囟 儿 夕	囟 儿 夂
𡖇	夕 夕
𡘋	太 太
𡛰	女 只
𡠟	女 属
𡥦	子 子 子
𡥧	子 尽
𡦪	𡥦 𡥦	子 子 子 子 子 子
𡩁	宀 亲
𡰲	尸 尸
𡱉	尹 尹
𡵌	山 义
𡿭	巛 巛
𢀌	巢 巢
𢀖	乛 丿 工
𢀡	左 左
𢁝	巾 巾
𢂏	巿 巿
𢃇	巾 里
𢆡	乳 年
𢌽	卅 卅
𢑑	彐 彐
𢗰	心 心
𢝵	飛 心
𢞵	飛 必
𢠃	猄 心
𢨋	或 或
𢨯	户 户
𢨳	户 户
𢩙	启 启
𢫊	扌 对	扌 对	才 对
𢫏	扌 冚	才 冚	手 冖 山
𢫏	扌 冚	扌 冚	才 冚
𢫨	手 戎	扌 戎	才 戎
𢭃	手 豆	扌 豆	才 豆
𢮁	手 於	扌 於	才 於
𢮂	手 弦	扌 弦	才 弦
𢮇	手 士 母	扌 士 母	才 士 母
𢮈	手 忿	扌 忿	才 忿
𢮉	手 厂 兆	扌 厂 兆	才 厂 兆
𢮊	手 軋	扌 軋	才 軋
𢮋	手 承	扌 承	才 承
𢮍	手 穹	扌 穹	才 穹
𢮎	手 虎	扌 虎	才 虎
𢮏	手 咅
𢮐	手 尚	扌 尚	才 尚
𢮑	手 彔	扌 彔	才 彔
𢮒	手 阜	扌 阜	才 阜
𢮓	手 制	扌 制	才 制
𢮜	基 手
𢮝	取 手
𢯊	手 的	扌 的	才 的
𢯎	手 肴	扌 肴	才 肴
𢯩	手 則	扌 則	才 則
𢯪	手 广 屰	扌 广 屰	才 广 屰
𢯫	手 段	扌 段	才 段
𢯮	手 胃	扌 胃	才 胃
𢯰	手 律	扌 律	才 律
𢯲	目 叉 手
𢯵	手 目 夬	扌 目 夬	才 目 夬
𢯶	手 室	扌 室	才 室
𢯷	手 韋	扌 韋	才 韋
𢯹	手 革	扌 革	才 革
𢯺	手 禹	扌 禹	才 禹
𢯼	手 衍	扌 衍	才 衍
𢯽	手 苴	扌 苴	才 苴
𢯾	手 冒	扌 冒	才 冒
𢯿	手 苞	扌 苞	才 苞
𢰃	手 穾	扌 穾	才 穾
𢰅	手 弜 一 八	扌 弜 一 八	才 弜 一 八
𢰆	手 苻	扌 苻	才 苻
𢰋	手 囗 而	扌 囗 而	才 囗 而
𢰌	手 罒 心	手 网 心	扌 罒 心	扌 网 心	才 罒 心	才 网 心
𢰍	手 亠 口 火	扌 亠 口 火	才 亠 口 火
𢰏	手 孚	扌 孚	才 孚
𢰙	手 至 寸	扌 至 寸	才 至 寸
𢰝	手 茂	扌 茂	才 茂
𢰞	敃 手
𢰠	手 幽	扌 幽	才 幽
𢰡	手 侯	扌 侯	才 侯
𢰢	手 首	扌 首	才 首
𢰥	手 苔	扌 苔	才 苔
𢰦	手 春	扌 春	才 春
𢰧	手 斿	扌 斿	才 斿
𢰨	恆 手
𢰩	手 兹	扌 兹	才 兹
𢰫	手 工 兆	扌 工 兆	才 工 兆
𢰬	手 隶	扌 隶	才 隶
𢰭	手 勇	扌 勇	才 勇
𢰮	手 胡	扌 胡	才 胡
𢰯	手 枣	扌 枣	才 枣
𢰲	手 眉	扌 眉	才 眉
𢰳	手 要	扌 要	才 要
𢰴	手 故	扌 故	才 故
𢰶	扌 英	扌 英	才 英
𢰷	手 点	扌 点	才 点
𢰸	手 咼	扌 咼	才 咼
𢰹	手 約	扌 約	才 約
𢰺	手 負	扌 負	才 負
𢰻	手 臼 丨 丂	扌 臼 丨 丂	才 臼 丨 丂
𢰽	手 急	扌 急	才 急
𢰾	手 怠	扌 怠	才 怠
𢱁	手 苜	扌 苜	才 苜
𢱃	手 科	扌 科	才 科
𢱆	手 咨	扌 咨	才 咨
𢱈	手 叚	扌 叚	才 叚
𢱉	手 歪	扌 歪	才 歪
𢱋	手 度	扌 度	才 度
𢱍	手 勉	扌 勉	才 勉
𢱎	手 拜	扌 拜	才 拜
𢱏	手 訂	扌 訂	才 訂
𢱐	手 姚	扌 姚	才 姚
𢱑	手 穴 爪	扌 穴 爪	才 穴 爪
𢱒	手 美	扌 美	才 美
𢱓	手 洗	扌 洗	才 洗
𢱔	手 盆	扌 盆	才 盆
𢱕	手 耷	扌 耷	才 耷
𢱖	手 某	扌 某	才 某
𢱗	手 苦	扌 苦	才 苦
𢱘	手 彥	扌 彥	才 彥
𢱙	手 孩	扌 孩	才 孩
𢱚	手 風	扌 風	才 風
𢱛	手 洒	扌 洒	才 洒
𢱜	手 待	扌 待	才 待
𢱝	手 茁	扌 茁	才 茁
𢱞	手 茁
𢳆	手 敖	扌 敖	才 敖
𢴈	手 笪	扌 笪	才 笪
𢶤	手 靴	扌 靴	才 靴
𢷮	扌 對	扌 對	才 對
𢺋	難 手
𢺳	手 蠻	扌 蠻	才 蠻
𢺸	支 支
𣅠	日 气
𣊣	昔 昔
𣊧	明 明
𣊫	昌 昌
𣊷	易 易
𣏪	木 双
𣖕	木 屏
𣗋	土 党
𣗥	束 束
𣚺	未 成 母
𣛕	果 果
𣢐	欠 欠
𣥒	止 止
𣥕	止 止
𣥖	止 止
𣥗	止 止
𣥠	止 止
𣫯	母 母
𣬅	比 比
𣱝	气 东
𣲗	水 韦	氵 韦
𣲘	水 无	氵 无
𣲷	氵 囗 又
𣴏	永 永
𣸣	水 贲	氵 贲
𤆓	火 广
𤆣	火 及
𤇃	火 厉
𤊓	火 兒
𤎓	青 灵
𤎓	青 靈
𤓓	火 羅
𤘅	牙 子
𤘆	牙 牙
𤘧	牛 牛
𤚅	牟 牟
𤜷	犬 互	犭 互
𤟠	犬 胥
𤧛	王 帝	玉 帝 
𤩽	王 献	玉 献 
𤫉	王 火 言 火 又 	玉 火 言 火 又	王 燮	玉 燮
𤭢	卒 瓦
𤱓	申 申
𤲶	男 男
𤶸	疒 那
𤷈	疒 奈
𤷪	疒 孟
𤺧	疒 曾
𥄫	目 及
𥇣	目 屈
𥊙	目 𡕩	目 㚇
𥊙	目 𡕩	目 㚇	目 囟 儿 夕
𥊼	目 牚
𥋇	目 掌
𥔲	石 咢
𥕢	石 曹
𥖨	石 喿
𥝉	禺 禺
𥡝	秉 秉
𥹉	米 囗 又
𥹫	米 米
𥻗	米 查
𦈡	纟 需
𦒍	童 羽
𦓔	而 而
𦗒	耳 郭
𦙶	月 古	肉 古
𦝼	月 娄	肉 娄
𦟌	肉 展	月 展
𦢓	肉 墨	月 墨
𦣞	匚 丨 口 丨
𦣦	臣 臣
𦣩	臣 臣
𦧚	舌 舌
𦧲	舌 累
𦧺	舌 賴
𦭜	艹 只
𦰡	艹 那
𧈢	虫 八
𧈢	蟲 八
𧊄	虫 只	虫 只
𧊅	虫 另
𧊅	蟲 另	虫 另
𧋦	虫 尾
𧋦	蟲 尾	虫 尾
𧕴	難 蟲	難 虫
𧘹	衤 太
𧢝	厲 見
𧥺	言 勻
𧨟	言 言
𧩙	言 廴 旦
𧬪	言 運
𧮪	言 占	讠 占
𧴌	豸 菐
𧹖	贝 典
𧹗	贝 患
𧼂	走 走
𧿹	足 母
𨂾	足 南
𨃩	足 扇
𨅝	足 牚
𨆪	輕 足
𨈓	身 小
𨋢	車 立
𨐈	车 光
𨙸	支 阝
𨚕	弁 阝
𨛜	邑 邑
𨟠	瞿 阝
𨭉	斌 金
𨱇	钅 求
𨱏	钅 荅
𨱑	钅 黄
𨱔	钅 尊
𨳊	門 九
𨳍	門 七
𨳒	門 小
𨶙	門 能
𨺙	阝 兒
𨽼	隶 隶
𩈲	面 面
𩈳	面 面
𩓙	匕 矢 頁
𩓥	岳 頁
𩗴	風 奉
𩡌	香 香
𩡐	香 香
𩥋	马 马
𩩍	骨 甹
𩬎	髟 壬
𩵺	魚 月
𩶘	魚 立
𩺰	鱼 鱼
𩽹	鱼 及
𩽼	鱼 军
𩽾	鱼 安
𩾃	鱼 免
𩾌	鱼 康
𪅝	鳥 鳥
𪙹	齒 齒
𪟝	责 力
𪠳	口 车
𪠸	口 乐
𪡀	口 乔
𪡃	口 买
𪡈	口 伯
𪡋	口 佥
𪡏	口 连
𪡞	口 贵
𪡞	囗 贵
𪢐	口 赖
𪢕	口 赘
𪢮	囗 栾
𪢸	土 无
𪣻	土 娄
𪤗	土 翏
𪤚	土 联
𪥫	女 双
𪥰	女 宁
𪥿	女 卖
𪧀	子 婴
𪨊	尸 从	尸 人 人
𪨧	山 仑
𪨰	山 曲
𪨶	山 大 车
𪨷	山 严
𪩘	山 献
𪩸	巾 贲
𪪞	广 啬
𪪼	弓 毕
𪮳	手 蛮	扌 蛮	才 蛮
𪱾	木 尔
𪲔	木 丽
𪸩	火 军
𪾢	目 见
𫄧	纟 延
𫄨	纟 希
𫄷	纟 意
𫄸	纟 熏
𫅓	羊 羊
𫇆	臣 臣
𫇭	艹 为
𫊮	虫 卢	虫 卢
𫊱	尔 虫	尔 虫
𫊸	虫 乔	虫 乔
𫌀	衤 责
𫌨	尔 见
𫌪	厂 氏 见	𠂢 见
𫌭	见 微
𫍚	言 乔	讠 乔
𫍜	言 去	讠 去
𫍝	言 东	讠 东
𫍡	言 它	讠 它
𫍣	言 同	讠 同
𫍥	言 兆	讠 兆
𫍦	言 农	讠 农
𫍬	言 罔	讠 罔
𫍮	言 屈	讠 屈
𫍯	讠 咸
𫍰	言 思	讠 思
𫍱	言 耑	讠 耑	言 山 而
𫍲	讠 叟
𫍳	言 重	讠 重
𫍴	言 娄	讠 娄
𫍸	言 扇	讠 扇
𫍽	讠 睘
𫎩	贝 罙
𫎫	贝 覃
𫎬	章 贡
𫐄	车 兀
𫐅	车 山
𫐆	车 历
𫐈	车 犮
𫐉	车 令
𫐌	车 并
𫐎	车 奇
𫐏	车 周
𫐐	车 兒
𫐑	车 官
𫐓	车 柔
𫐕	车 彗
𫐘	车 睘
𫐙	车 畾	车 田 田 田
𫑡	黾 阝	口 电 阝
𫓧	钅 夫
𫓯	钅 圭
𫓶	钅 肙	钅 口 月
𫓹	钅 其
𫔍	钅 番
𫔎	钅 矞	钅 矛 囧
𫔶	门 臬
𫖮	岂 页
𫖯	兆 页
𫖳	君 页
𫗧	饣 束
𫗴	饣 亶	饣 亠 回 旦
𫘜	马  文
𫘝	马 夬	马 折 大
𫘦	马 匋	马 勹 缶
𫘧	马 录
𫘨	马 是
𫘪	马 原
𫘬	马 奚
𫚉	鱼 工
𫚌	鱼 少
𫚍	鱼 分
𫚐	鱼 央
𫚑	鱼 必
𫚒	鱼 弗
𫚔	鱼 回
𫚕	鱼 师
𫚖	此 鱼
𫚗	鱼 合
𫚙	鱼 甫
𫚛	鱼 兑
𫚡	鱼 帚
𫚢	鱼 匽
𫚣	鱼 便
𫚥	鱼 叚
𫚦	鱼 容
𫚧	鱼 曹
𫚭	鱼 巤	鱼 巛 囗 乂 𠄌 丶 丶 𠄌 丶 丶 乀
𫛭	狂 鸟
𫜪	齿 交
𫜬	齿 昔
𫜭	齿 所
𫜮	齿 彦
𫜰	献 齿
𫜲	有 龙
𫝩	女 寿
𫝬	女 贵
𫝭	女 婴
𫞗	水 闵	氵 闵
𫞩	王 艹 两	玉 艹 两
𫟅	纟 京
𫟟	言 半	讠 半
𫟠	言 单	讠 单
𫟦	车 遂
𫟹	钅 共
𫟼	钅 达
𫠆	支 页
𫠊	马 玄
𫠐	鱼 甘
𫠜	齿 兒
𫠭	不 不
𫢒	人 龙	亻 龙
𫢙	人 动	亻 动
𫢪	人 连	亻 连
𫢬	人 劳	亻 劳
𫢭	人 草 为	亻 艸 为	亻 艹 为
𫢸	人 单	亻 单
𫢺	人 参	亻 参
𫣉	人 监	亻 监
𫣊	人 爱	亻 爱
𫧯	卜 呙	占 内	卜 口 内
𫩕	口 广
𫩥	口 旧
𫩪	口 兰
𫩫	口 厌
𫩺	口 尽
𫪁	口 来
𫪃	口 丽
𫪈	口 系
𫪧	口 枭
𫫇	口 恶
𫫦	口 阎
𫫾	口 频
𫭞	土 专
𫭟	土 区
𫭢	土 仑
𫭨	土 发
𫭪	土 尧
𫭲	土 严
𫭼	土 劳
𫮃	土 单
𫮅	土 参
𫯶	大 渊
𫰂	奢 单
𫰍	女 韦
𫰛	女 𢀖	女 乛 丿 工
𫰢	女 会
𫵷	山 历
𫶇	山 带
𫷷	广 钦
𫸩	弓 区
𬀩	日 韦
𬀪	日 见
𬀱	日 岂
𬂩	木 夹
𬂰	木 农
𬃊	木 质
𬃫	木 宪
𬃷	束 束
𬇕	氵 万
𬇘	水 专	氵 专
𬇙	水 贝	氵 贝
𬇹	水 国	氵 国
𬈧	水 啬	氵 啬
𬉼	火 区
𬊈	火 寻
𬊜	火 罗
𬊤	火 单
𬌗	牙 合
𬍛	王 乐	玉 乐
𬍡	汤 玉
𬍤	王 寻	玉 寻
𬒈	丶 丶 丿 冖 石
𬒔	石 肯
𬒗	石 览
𬓫	禾 龟
𬕂	竹 贡
𬘓	纟 川
𬘘	纟 冘
𬘡	纟 因
𬘩	纟 廷
𬘫	纟 完
𬘬	纟 青
𬘭	纟 林
𬘯	纟 享
𬙂	纟 寅
𬙊	纟 墨
𬙋	纟 襄
𬚿	肉 闲
𬚿	肉 閑
𬜬	艹 问
𬜯	艹 两
𬞟	艹 频
𬟁	艹 鬲 鸟
𬟽	虫 东	虫 东
𬢊	司 见
𬢋	兆 见
𬢌	志 见
𬢎	者 见
𬢒	冥 见
𬢔	登 见
𬣙	讠 于
𬣞	讠 宀 一
𬣠	言 甘	讠 甘
𬣡	讠 戋
𬣥	言 山 又	讠 山 又	讠 屮 又
𬣦	言 幼	讠 幼
𬣩	言 有	讠 有
𬣭	言 当	讠 当
𬣮	言 名	讠 名
𬣰	言 自	讠 自
𬣱	言 州	讠 州
𬣲	言 并	讠 并
𬣳	言 艮	讠 艮
𬣻	言 廷	讠 廷
𬣾	言 昔	讠 昔
𬤀	言 虎	讠 虎
𬤄	言 参	讠 参
𬤇	讠 垔	讠 西 土
𬤊	言 是	讠 是
𬤍	言 皇	讠 皇
𬤎	言 宣	讠 宣
𬤐	言 哥	讠 哥
𬤙	言 虖	讠 虖
𬤛	言 阎	讠 阎
𬤝	言 惠	讠 惠
𬤣	言 敦	讠 敦
𬤤	言 曾	讠 曾
𬤥	言 巽	讠 巽
𬤦	言 遗	讠 遗
𬤨	言 喿	讠 喿
𬤩	言 疑	讠 疑
𬤫	言 豪	讠 豪
𬤭	言 慧	讠 慧
𬤮	言 赞	讠 赞
𬥳	贝 仓
𬥸	贝 串
𬨁	车 毛
𬨂	车 氏
𬨄	车 央
𬨇	车 亥
𬨈	车 免
𬨎	车 酋
𬨓	车 巢
𬩽	寻 阝
𬪩	酉 农
𬬩	钅 弋
𬬭	钅 仑
𬬮	钅 长
𬬱	钅 斤
𬬸	钅 术
𬬹	钅 申
𬬻	钅 卢
𬬿	钅 召
𬭁	钅 母
𬭊	钅 杜
𬭎	钅 宏
𬭚	钅 享
𬭛	钅 波
𬭤	钅 侯
𬭩	钅 翁
𬭬	钅 彗
𬭯	钅 敝 
𬭳	钅 喜
𬭶	钅 黑
𬭸	钅 粦
𬭼	钅 遂
𬮟	门 火
𬮱	门 垔
𬮿	阝 山 己	阝 岂
𬯀	阝 齐
𬯎	阝 贵	耳 贵
𬱖	由 页
𬱟	危 页
𬳵	马 丕
𬳶	马 冋	马 冂 口
𬳽	马 先
𬳿	马 余
𬴂	马 非
𬴃	马 丰 石
𬴊	马 粦
𬶀	鱼 刀	鱼 刂
𬶁	鱼 人
𬶄	鱼 勺
𬶇	鱼 介
𬶈	鱼 月
𬶋	鱼 句
𬶍	鱼 它
𬶏	鱼 危
𬶐	鱼 兆
𬶔	鱼 告
𬶕	鱼 弟
𬶞	鱼 胡
𬶟	鱼 剌
𬶠	鱼 柬
𬶢	鱼 星
𬶧	鱼 柔
𬶨	既 鱼
𬶭	鱼 祭
𬶮	鱼 喜
𬷕	甫 鸟
𬸘	匚 日 女 鸟
𬸚	狱 鸟
𬸣	宀 井 大 鸟
𬸦	旅 鸟
𬸪	番 鸟
𬹺	齿 牙
𬹼	齿 介
𬺈	齿 奇
𬺎	差 齿
𬺓	齿 楚
𬺔	齿 禁
𬼆	㐅 㐅
𬼠	乞 乞
𭄛	赞 刀	赞 刂
𭇯	口 刘
𭎜	土 寿
𭏸	土 遗
𭐪	夋 夋
𭑈	天 天
𭚦	弓 广
𭥗	曰 曰
𮊂	罒 罒
𮤭	门 小
𮬛	鱼 予
𮬜	鱼 旨
𰂏	人 卖	亻 卖
𰂦	人 虑	亻 虑
𰂭	人 赐	亻 赐
𰃆	人 赞	亻 赞
𰃿	冰 卖	冫 卖
𰇕	口 夹
𰇣	口 戏
𰈊	口 点
𰈍	口 亲
𰈯	口 献
𰉄	口 赞
𰋹	女 专
𰌂	女 贞
𰌇	女 责
𰏵	光 广
𰏶	广 会
𰑄	心 仑	忄 仑
𰛦	水 岁	氵 岁
𱆥	魚 丹
𱇏	鱼 乇
𱇐	鱼 元
𱇒	鱼 比
𱇓	鱼 互
𱇔	鱼 内
𱇖	鱼 反
𱇗	鱼 仑
𱇘	鱼 亢
𱇙	鱼 冘
𱇛	鱼 未
𱇜	鱼 去
𱇝	鱼 丕
𱇟	鱼 甲
𱇠	鱼 囚
𱇡	鱼 生
𱇢	鱼 玄
𱇧	鱼 夷
𱇨	鱼 尗
𱇪	鱼 各
𱇭	鱼 来
𱇯	鱼 肖
𱇵	鱼 责
𱇺	鱼 季
𱇾	鱼 宗
𱈂	鱼 禺
𱈄	鱼 侯
𱈊	鱼 留
𱈋	鱼 高
𱌘	齐 皿
𱌫	齿 只
𱌬	齿 乍
𱌭	齿 刍
𱌯	齿 台
𱌱	齿 曳
𱌳	齿 军
𱌶	齿 取
𱌹	齿 禺
𱌺	齿 真
𱌽	齿 益
𱍂	龙 龙
	口 賴